X82,nd,bra,pre,par,ama,ind,total,nao_bra_prop,nao_bra_prop_declarados
35000012,194,269,16,77,1,1,558,51.79211469534051,26.098901098901095
35000024,870,859,97,653,3,4,2486,65.44650040225261,46.8440594059406
35000036,464,1105,102,676,2,3,2352,53.0187074829932,41.472457627118644
35000048,150,459,53,357,7,2,1028,55.35019455252919,47.722095671981776
35000059,214,390,31,335,3,0,973,59.91778006166495,48.61660079051383
35000061,354,293,21,219,4,0,891,67.11560044893379,45.43761638733705
35000073,143,164,23,129,0,1,460,64.34782608695653,48.26498422712934
35000085,245,199,24,122,0,0,590,66.27118644067797,42.31884057971015
35000097,481,398,59,318,3,4,1263,68.48772763262075,49.10485933503836
35000103,389,285,31,272,3,1,981,70.9480122324159,51.85810810810811
35000115,398,235,17,184,2,0,836,71.88995215311004,46.34703196347032
35000127,243,342,9,159,1,1,755,54.70198675496689,33.203125
35000139,275,689,50,227,1,3,1245,44.65863453815261,28.96907216494845
35000140,83,273,23,134,0,0,513,46.783625730994146,36.51162790697674
35000152,185,92,6,39,0,0,322,71.42857142857143,32.846715328467155
35000164,199,302,30,94,1,0,626,51.75718849840256,29.274004683840747
35000176,403,507,53,308,1,5,1277,60.297572435395466,41.9908466819222
35000188,283,490,25,222,0,1,1021,52.007835455435846,33.60433604336044
35000197,285,373,38,225,1,6,928,59.80603448275862,41.990668740279936
35000206,180,315,10,165,2,0,672,53.125,35.97560975609756
35000218,167,346,37,179,1,1,731,52.667578659370726,38.652482269503544
35000224,299,776,54,349,6,12,1496,48.12834224598931,35.17126148705096
35000231,232,440,61,324,1,0,1058,58.41209829867675,46.73123486682809
35000243,232,140,16,91,0,1,480,70.83333333333333,43.548387096774185
35000255,139,376,49,205,4,0,773,51.35834411384217,40.694006309148264
35000267,209,695,33,203,4,1,1145,39.301310043668124,25.747863247863243
35000279,474,351,31,220,2,1,1079,67.46987951807229,41.98347107438016
35000280,282,1056,84,683,1,1,2107,49.88134788799241,42.13698630136986
35000292,178,177,31,157,4,1,548,67.7007299270073,52.16216216216216
35000309,10,285,48,165,2,1,511,44.22700587084149,43.113772455089816
35000310,187,136,14,116,2,4,459,70.37037037037037,50
35000322,189,307,38,160,2,5,701,56.20542082738944,40.0390625
35000334,207,555,50,192,9,4,1017,45.427728613569315,31.481481481481477
35000346,221,307,25,90,2,0,645,52.4031007751938,27.594339622641506
35000358,205,224,50,194,5,4,682,67.15542521994135,53.03983228511531
35000361,170,396,35,126,0,0,727,45.529573590096284,28.904847396768407
35000371,332,764,87,413,5,1,1602,52.30961298377028,39.84251968503937
35000383,98,634,73,347,2,2,1156,45.155709342560556,40.07561436672968
35000395,168,558,63,322,4,0,1115,49.95515695067264,41.07708553326294
35000401,115,712,67,257,6,1,1158,38.5146804835924,31.73537871524449
35000413,140,389,37,179,2,3,750,48.133333333333326,36.22950819672132
35000425,303,268,20,179,1,0,771,65.23994811932555,42.73504273504274
35000437,252,219,26,105,0,1,603,63.681592039801,37.60683760683761
35000449,148,178,15,95,0,1,437,59.26773455377574,38.4083044982699
35000450,152,550,23,166,3,1,895,38.547486033519554,25.97577388963661
35000462,315,410,78,216,4,4,1027,60.07789678675755,42.41573033707865
35000474,144,238,15,77,0,0,474,49.789029535864984,27.878787878787882
35000486,332,703,36,208,9,6,1294,45.672333848531686,26.923076923076927
35000498,166,328,62,230,2,3,791,58.53350189633375,47.519999999999996
35000504,313,361,45,192,3,0,914,60.50328227571116,39.93344425956739
35000516,159,215,23,92,4,9,502,57.17131474103585,37.31778425655977
35000528,136,260,57,202,3,9,667,61.019490254872565,51.03578154425612
35000536,278,655,76,320,3,1,1333,50.862715678919734,37.91469194312796
35000541,138,212,44,240,0,69,703,69.84352773826458,62.477876106194685
35000553,220,1263,99,363,2,2,1949,35.19753719856337,26.95199537304801
35000565,169,176,12,140,1,0,498,64.65863453815261,46.50455927051672
35000577,51,121,22,79,2,2,277,56.317689530685925,46.46017699115043
35000589,59,192,20,87,1,1,360,46.666666666666664,36.21262458471761
35000590,15,311,60,241,1,1,629,50.5564387917329,49.348534201954394
35000607,414,656,105,434,2,11,1622,59.556103575832296,45.6953642384106
35000619,178,220,13,84,0,0,495,55.55555555555556,30.5993690851735
35000620,193,567,41,274,0,3,1078,47.4025974025974,35.932203389830505
35000632,133,141,17,76,2,0,369,61.78861788617886,40.2542372881356
35000644,78,123,13,51,1,0,266,53.75939849624061,34.57446808510638
35000656,75,143,9,50,0,0,277,48.375451263537904,29.20792079207921
35000668,204,329,25,135,7,3,703,53.200568990042676,34.06813627254509
35000673,218,636,49,443,4,6,1356,53.09734513274336,44.11247803163445
35000681,225,224,7,115,2,7,580,61.37931034482759,36.901408450704224
35000693,254,431,40,304,2,1,1032,58.23643410852712,44.601542416452446
35000700,184,334,18,337,3,6,882,62.131519274376416,52.148997134670495
35000711,147,316,23,96,3,1,586,46.07508532423208,28.018223234624152
35000723,104,274,8,119,1,0,506,45.8498023715415,31.8407960199005
35000735,374,917,73,315,1,5,1685,45.5786350148368,30.053394355453854
35000747,175,484,42,241,3,9,954,49.26624737945493,37.869062901155324
35000759,94,374,12,315,0,4,799,53.191489361702125,46.95035460992908
35000760,129,324,13,132,3,6,607,46.62273476112026,32.21757322175732
35000772,284,279,20,85,3,2,673,58.543833580980674,28.277634961439592
35000784,132,156,8,187,5,7,495,68.48484848484848,57.02479338842975
35000796,121,513,31,361,1,0,1027,50.04868549172347,43.377483443708606
35000802,110,415,35,216,3,6,785,47.13375796178344,38.51851851851852
35000814,224,245,42,218,0,1,730,66.43835616438356,51.581027667984195
35000838,226,505,39,334,2,0,1106,54.33996383363472,42.61363636363637
35000848,1185,125,12,45,1,4,1372,90.88921282798835,33.155080213903744
35000851,70,209,10,222,5,5,521,59.88483685220729,53.65853658536586
35000863,339,239,11,39,3,0,631,62.12361331220285,18.150684931506845
35000875,139,293,19,100,1,1,553,47.01627486437613,29.227053140096615
35000899,162,138,8,45,0,2,355,61.12676056338029,28.497409326424872
35000905,141,270,10,85,0,0,506,46.640316205533594,26.027397260273975
35000917,230,385,34,124,1,1,775,50.32258064516129,29.357798165137616
35000929,172,433,28,141,5,2,781,44.55825864276568,28.899835796387517
35000930,72,119,9,42,0,0,242,50.82644628099173,30.000000000000004
35000942,82,220,10,95,5,0,412,46.601941747572816,33.333333333333336
35000954,630,1040,75,405,10,5,2165,51.96304849884527,32.247557003257334
35000966,90,279,23,99,3,4,498,43.975903614457835,31.61764705882353
35000978,99,334,13,107,5,2,560,40.35714285714286,27.54880694143167
35000985,200,273,29,100,4,1,607,55.024711696869844,32.92383292383292
35001004,185,512,36,248,2,2,985,48.02030456852792,36
35001016,339,793,58,396,5,2,1593,50.219711236660395,36.76236044657097
35001028,113,416,45,276,2,0,852,51.1737089201878,43.707713125845736
35001036,137,375,41,201,1,2,757,50.46235138705416,39.516129032258064
35001041,150,328,31,174,1,1,685,52.11678832116788,38.691588785046726
35001053,253,208,17,124,0,1,603,65.50580431177447,40.57142857142857
35001065,331,310,13,129,3,3,789,60.70975918884665,32.314410480349345
35001077,441,411,21,151,2,1,1027,59.98052580331061,29.86348122866894
35001089,112,362,29,136,1,3,643,43.701399688958006,31.826741996233523
35001090,299,336,24,276,5,3,943,64.36903499469777,47.82608695652174
35001119,129,305,20,201,5,48,708,56.92090395480226,47.32297063903281
35001120,247,378,17,73,12,0,727,48.00550206327373,21.250000000000004
35001132,188,459,23,188,2,4,864,46.875,32.100591715976336
35001144,225,536,44,287,2,0,1094,51.0054844606947,38.3199079401611
35001156,170,1027,96,420,7,0,1720,40.29069767441861,33.74193548387097
35001168,178,431,25,200,5,1,840,48.6904761904762,34.89425981873112
35001173,301,777,52,291,10,3,1434,45.81589958158996,31.421006178287737
35001181,275,406,13,143,1,0,838,51.551312649164686,27.886323268206038
35001193,237,537,14,267,8,1,1064,49.53007518796993,35.06650544135429
35001200,241,510,25,205,3,12,996,48.795180722891565,32.450331125827816
35001211,129,103,13,63,0,2,310,66.77419354838709,43.0939226519337
35001223,79,203,9,106,1,0,398,48.994974874371856,36.36363636363637
35001235,298,388,57,271,1,7,1022,62.03522504892368,46.408839779005525
35001247,266,378,15,120,1,0,780,51.53846153846153,26.45914396887159
35001259,147,401,16,164,2,1,731,45.14363885088919,31.335616438356162
35001272,110,522,75,260,1,3,971,46.24098867147271,39.37282229965157
35001284,142,337,20,112,2,1,614,45.11400651465798,28.60169491525424
35001296,219,455,31,231,3,4,943,51.749734888653244,37.15469613259669
35001302,129,194,18,110,1,1,453,57.17439293598234,40.123456790123456
35001314,374,155,11,89,0,3,632,75.4746835443038,39.92248062015504
35001326,327,380,38,224,4,2,975,61.02564102564103,41.35802469135802
35001338,308,250,19,109,0,0,686,63.55685131195335,33.86243386243386
35001348,245,508,41,428,2,5,1229,58.665581773799836,48.3739837398374
35001351,320,268,16,164,4,4,776,65.4639175257732,41.22807017543859
35001363,40,81,7,41,1,0,170,52.352941176470594,37.69230769230769
35001375,105,202,21,120,2,2,452,55.30973451327434,41.78674351585015
35001387,132,122,4,27,0,1,286,57.34265734265735,20.779220779220775
35001399,123,164,9,49,2,0,347,52.73775216138328,26.785714285714292
35001405,541,166,10,88,10,3,818,79.70660146699267,40.07220216606498
35001417,75,140,14,41,0,1,271,48.33948339483395,28.57142857142857
35001430,59,389,26,93,3,0,570,31.75438596491228,23.874755381604697
35001442,177,336,9,76,4,4,606,44.55445544554455,21.678321678321677
35001454,281,365,34,204,4,7,895,59.21787709497206,40.553745928338756
35001466,94,235,13,219,4,0,565,58.4070796460177,50.10615711252654
35001478,555,316,15,173,18,18,1095,71.14155251141551,41.48148148148149
35001485,67,129,14,90,4,2,306,57.843137254901954,46.02510460251046
35001491,112,334,12,82,2,3,545,38.715596330275226,22.863741339491916
35001508,141,193,11,59,12,2,418,53.827751196172244,30.324909747292416
35001512,142,345,10,101,12,3,613,43.719412724306686,26.751592356687905
35001521,404,415,36,223,16,19,1113,62.713387241689134,41.46685472496474
35001545,127,256,12,57,5,5,462,44.58874458874459,23.582089552238806
35001569,229,539,19,121,20,24,952,43.38235294117647,25.44951590594744
35001570,690,356,21,285,17,12,1381,74.22157856625633,48.480463096960925
35001582,302,237,20,189,52,29,829,71.41133896260554,55.02846299810247
35001594,564,614,45,282,6,3,1514,59.445178335535,35.36842105263158
35001600,162,415,21,139,8,4,749,44.592790387182916,29.3015332197615
35001624,335,1082,39,188,6,3,1653,34.543254688445245,17.90591805766313
35001636,303,784,30,177,24,1,1319,40.56103108415466,22.83464566929134
35001659,502,417,33,249,21,20,1242,66.42512077294687,43.648648648648646
35001661,130,290,12,63,3,2,500,42.00000000000001,21.62162162162162
35001673,161,480,29,226,1,1,898,46.5478841870824,34.871099050203526
35001685,138,256,12,128,1,2,537,52.32774674115457,35.83959899749374
35001697,393,621,23,147,5,0,1189,47.77123633305299,21.984924623115575
35001703,211,1070,36,212,9,3,1541,30.564568462037634,19.548872180451127
35001727,316,735,74,349,1,3,1478,50.27063599458727,36.74698795180723
35001739,123,198,4,66,1,0,392,49.48979591836735,26.394052044609662
35001740,95,314,20,95,6,1,531,40.866290018832395,27.981651376146786
35001752,443,1266,73,563,2,6,2353,46.19634509137271,33.71727748691099
35001764,104,235,11,55,1,1,407,42.26044226044227,22.442244224422446
35001776,169,361,12,125,6,1,674,46.439169139465875,28.51485148514852
35001788,49,206,7,48,0,0,310,33.54838709677419,21.0727969348659
35001797,64,222,3,86,0,0,375,40.800000000000004,28.617363344051448
35001806,91,193,6,58,2,2,352,45.17045454545454,26.053639846743295
35001818,316,214,17,85,5,0,637,66.40502354788069,33.333333333333336
35001824,110,341,6,82,3,2,544,37.31617647058824,21.42857142857143
35001843,139,512,28,211,4,5,899,43.04783092324806,32.631578947368425
35001855,29,105,7,45,0,0,186,43.548387096774185,33.12101910828026
35001867,259,620,30,153,2,0,1064,41.72932330827067,22.981366459627328
35001879,148,240,6,97,0,0,491,51.12016293279022,30.029154518950442
35001880,305,1191,62,294,5,4,1861,36.002149382052664,23.457583547557835
35001892,134,209,15,74,2,1,435,51.954022988505756,30.564784053156146
35001909,42,269,15,143,0,0,469,42.643923240938165,37.002341920374704
35001910,55,140,8,33,2,1,239,41.42259414225941,23.913043478260864
35001922,111,219,10,67,2,0,409,46.45476772616137,26.51006711409396
35001934,119,406,30,192,4,1,752,46.01063829787234,35.8609794628752
35001946,471,626,40,188,10,5,1340,53.28358208955224,27.963176064441885
35001958,197,644,30,161,12,1,1045,38.37320574162679,24.056603773584907
35001961,235,306,14,117,0,1,673,54.53194650817237,30.136986301369863
35001971,380,784,53,276,4,4,1501,47.76815456362426,30.06244424620874
35001995,260,260,8,29,10,0,567,54.14462081128748,15.309446254071657
35002008,121,512,51,152,4,1,841,39.120095124851375,28.888888888888886
35002012,311,221,42,109,1,1,685,67.73722627737226,40.90909090909091
35002021,217,153,10,40,1,1,422,63.74407582938388,25.365853658536587
35002045,188,144,7,36,2,0,377,61.80371352785146,23.809523809523814
35002057,206,530,33,132,10,1,912,41.885964912280706,24.929178470254953
35002069,131,391,27,169,1,1,720,45.69444444444445,33.616298811544986
35002070,255,136,4,20,1,0,416,67.3076923076923,15.527950310559003
35002082,428,418,14,48,3,0,911,54.11635565312842,13.457556935817806
35002094,117,183,13,41,2,0,356,48.59550561797753,23.43096234309623
35002100,219,231,16,89,5,4,564,59.04255319148937,33.04347826086956
35002112,369,444,44,204,2,1,1064,58.27067669172932,36.115107913669064
35002124,153,108,12,73,3,5,354,69.4915254237288,46.26865671641791
35002136,164,330,15,89,1,1,600,44.99999999999999,24.311926605504585
35002148,179,390,14,116,1,1,701,44.36519258202568,25.287356321839084
35002159,74,124,10,37,2,0,247,49.79757085020243,28.32369942196532
35002161,130,343,24,93,2,0,592,42.060810810810814,25.757575757575758
35002173,267,826,23,105,4,0,1225,32.57142857142858,13.778705636743215
35002185,539,690,48,257,9,5,1548,55.42635658914728,31.615460852329036
35002197,231,802,46,170,26,3,1278,37.24569640062598,23.40019102196753
35002203,92,340,18,92,7,0,549,38.06921675774135,25.601750547045953
35002227,215,341,37,157,3,3,756,54.89417989417989,36.96857670979667
35002239,115,251,9,127,0,0,502,50,35.1421188630491
35002240,126,396,17,76,0,0,615,35.609756097560975,19.018404907975462
35002252,327,788,61,233,8,2,1419,44.46793516560958,27.83882783882784
35002264,484,828,79,445,8,5,1849,55.2190373174689,39.34065934065934
35002276,1,165,15,195,1,1,378,56.34920634920635,56.233421750663126
35002288,266,210,14,76,1,0,567,62.96296296296296,30.23255813953488
35002297,121,527,55,184,1,3,891,40.85297418630752,31.558441558441565
35002318,394,935,70,320,3,1,1723,45.7341845618108,29.646350639578635
35002331,273,1027,56,450,8,4,1818,43.50935093509351,33.52750809061489
35002343,372,263,46,124,4,0,809,67.49072929542646,39.81693363844394
35002355,202,108,9,39,0,0,358,69.83240223463687,30.76923076923077
35002367,190,238,16,74,1,1,520,54.23076923076924,27.878787878787882
35002379,153,100,7,69,7,9,345,71.01449275362319,47.916666666666664
35002380,570,321,16,212,6,9,1134,71.6931216931217,43.08510638297872
35002392,236,264,19,80,2,0,601,56.07321131447587,27.671232876712327
35002409,275,208,33,98,3,0,617,66.28849270664506,39.18128654970761
35002410,283,233,27,84,2,3,632,63.13291139240506,33.2378223495702
35002422,268,1017,107,332,5,1,1730,41.213872832369944,30.437756497948023
35002434,170,226,26,85,2,0,509,55.5992141453831,33.333333333333336
35002446,240,238,14,102,5,5,604,60.59602649006622,34.61538461538461
35002458,89,238,19,122,1,0,469,49.25373134328358,37.36842105263158
35002461,128,186,9,84,2,3,412,54.85436893203883,34.50704225352113
35002471,208,357,31,161,4,0,761,53.088042049934295,35.44303797468354
35002483,54,83,12,40,0,2,191,56.544502617801044,39.41605839416058
35002513,486,731,32,305,5,8,1567,53.35035098915124,32.37742830712303
35002525,423,426,39,225,5,12,1130,62.30088495575221,39.74540311173974
35002537,52,296,35,129,2,1,515,42.5242718446602,36.06911447084234
35002549,200,438,40,127,2,1,808,45.792079207920786,27.96052631578947
35002550,90,134,13,49,2,0,288,53.47222222222222,32.32323232323232
35002562,273,431,46,209,8,0,967,55.42916235780766,37.89625360230547
35002574,188,474,27,102,5,0,796,40.45226130653267,22.03947368421053
35002586,397,564,45,200,3,11,1220,53.77049180327869,31.470230862697445
35002598,215,252,27,185,1,1,681,62.99559471365639,45.922746781115876
35002616,311,467,65,278,0,2,1123,58.414959928762244,42.487684729064036
35002628,618,635,56,300,5,0,1614,60.65675340768277,36.24497991967871
35002636,336,539,75,273,3,3,1229,56.143205858421474,39.641657334826434
35002641,93,388,24,112,1,1,619,37.31825525040387,26.23574144486692
35002653,182,452,27,160,2,0,823,45.078979343863914,29.485179407176286
35002665,337,125,11,105,3,7,588,78.74149659863946,50.199203187250994
35002677,235,399,34,148,1,1,818,51.22249388753056,31.560891938250425
35002689,97,131,15,83,1,1,328,60.0609756097561,43.290043290043286
35002690,335,373,51,235,2,1,997,62.58776328986961,43.65558912386707
35002707,596,699,55,364,7,7,1728,59.548611111111114,38.25088339222616
35002719,238,266,28,180,2,4,718,62.95264623955432,44.58333333333333
35002720,203,323,53,219,1,3,802,59.725685785536164,46.076794657762946
35002732,381,272,27,162,4,10,856,68.22429906542055,42.736842105263165
35002744,173,467,36,261,1,1,939,50.26624068157615,39.03394255874674
35002756,491,222,14,108,2,2,839,73.5399284862932,36.206896551724135
35002768,573,165,10,57,2,0,807,79.5539033457249,29.487179487179482
35002773,534,499,43,383,5,15,1479,66.26098715348208,47.19576719576719
35002781,433,157,11,80,0,0,681,76.94566813509545,36.693548387096776
35002793,265,138,6,81,1,2,493,72.00811359026369,39.473684210526315
35002800,255,295,51,187,0,1,789,62.61089987325729,44.756554307116104
35002811,721,662,48,239,4,3,1677,60.52474657125819,30.753138075313814
35002823,279,207,15,90,1,0,592,65.03378378378379,33.86581469648562
35002835,325,262,24,210,0,0,821,68.08769792935445,47.17741935483871
35002847,570,517,29,239,3,6,1364,62.096774193548384,34.88664987405542
35002859,705,606,65,585,4,2,1967,69.1916624300966,51.98098256735341
35002860,527,457,59,452,1,2,1498,69.49265687583444,52.9351184346035
35002872,397,135,8,82,1,0,623,78.330658105939,40.26548672566371
35002884,123,189,21,133,0,3,469,59.70149253731343,45.3757225433526
35002896,199,306,30,229,0,0,764,59.94764397905759,45.84070796460177
35002902,470,686,45,404,11,2,1618,57.60197775030902,40.243902439024396
35002914,380,672,49,473,3,2,1579,57.44141861937935,43.95329441201001
35002926,354,355,30,240,4,2,985,63.959390862944154,43.74009508716323
35002938,473,213,16,142,0,0,844,74.76303317535545,42.58760107816711
35002948,490,242,21,184,1,1,939,74.22790202342918,46.10244988864143
35002951,77,104,8,60,0,0,249,58.23293172690763,39.53488372093024
35002963,465,300,31,295,1,3,1095,72.6027397260274,52.38095238095239
35002975,301,392,33,261,3,1,991,60.44399596367306,43.188405797101446
35002987,178,240,21,158,4,1,602,60.13289036544851,43.39622641509434
35002999,346,461,23,323,2,1,1156,60.12110726643598,43.086419753086425
35003001,282,271,33,225,3,0,814,66.70761670761671,49.06015037593985
35003013,540,314,34,285,4,1,1178,73.3446519524618,50.78369905956113
35003037,166,243,8,152,1,0,570,57.36842105263158,39.851485148514854
35003049,666,146,9,141,1,1,964,84.85477178423237,51.00671140939597
35003050,628,477,57,373,3,1,1539,69.00584795321637,47.63995609220637
35003062,397,814,62,385,6,1,1665,51.11111111111111,35.80441640378549
35003074,40,299,43,196,1,0,579,48.35924006908463,44.526901669758814
35003086,305,424,17,248,1,2,997,57.47241725175527,38.72832369942196
35003098,373,109,9,42,3,0,536,79.66417910447761,33.12883435582822
35003104,614,766,69,381,10,6,1846,58.504875406283865,37.824675324675326
35003116,310,526,48,263,3,2,1152,54.34027777777778,37.52969121140143
35003128,510,540,38,339,2,5,1434,62.34309623430963,41.55844155844156
35003136,156,138,12,90,0,2,398,65.32663316582914,42.97520661157025
35003141,315,259,18,206,0,2,800,67.625,46.597938144329895
35003153,152,199,34,138,1,1,525,62.095238095238095,46.64879356568365
35003165,413,268,15,95,2,0,793,66.20428751576293,29.47368421052632
35003177,391,166,16,200,0,0,773,78.52522639068565,56.544502617801044
35003189,387,289,28,178,2,1,885,67.34463276836158,41.967871485943775
35003190,232,172,13,94,1,2,514,66.53696498054475,39.00709219858156
35003207,317,113,11,82,1,1,525,78.47619047619048,45.67307692307693
35003219,339,255,10,93,0,0,697,63.41463414634146,28.77094972067039
35003220,572,714,62,477,3,5,1833,61.04746317512275,43.37827121332276
35003232,128,337,11,114,0,0,590,42.88135593220339,27.056277056277057
35003244,320,572,91,466,3,4,1456,60.71428571428572,49.647887323943664
35003256,460,379,54,300,2,2,1197,68.3375104427736,48.575305291723204
35003268,324,259,38,199,1,2,823,68.52976913730255,48.096192384769545
35003273,471,588,54,337,4,0,1454,59.55983493810179,40.18311291963378
35003281,568,303,20,191,3,1,1086,72.09944751381215,41.5057915057915
35003293,266,209,17,101,1,0,594,64.81481481481481,36.28048780487805
35003300,484,293,25,158,4,0,964,69.6058091286307,38.95833333333333
35003311,247,264,15,109,0,1,636,58.490566037735846,32.13367609254498
35003323,542,188,10,179,0,1,920,79.56521739130434,50.264550264550266
35003335,188,248,16,93,0,0,545,54.49541284403669,30.532212885154063
35003347,2,326,2,136,4,0,470,30.638297872340424,30.341880341880344
35003360,198,126,9,45,4,0,382,67.01570680628272,31.521739130434778
35003372,136,241,14,111,2,0,504,52.18253968253968,34.5108695652174
35003384,187,291,23,160,3,0,664,56.174698795180724,38.9937106918239
35003402,116,276,27,167,2,1,589,53.140916808149406,41.649048625792815
35003414,438,222,19,113,5,1,798,72.18045112781954,38.33333333333333
35003426,47,273,20,165,4,110,619,55.896607431340875,52.27272727272727
35003448,102,181,12,73,2,3,373,51.474530831099194,33.210332103321036
35003451,360,344,27,232,7,14,984,65.04065040650406,44.87179487179487
35003463,133,197,7,77,2,1,417,52.757793764988016,30.63380281690141
35003475,110,152,11,55,3,0,331,54.0785498489426,31.221719457013574
35003487,235,215,16,68,1,0,535,59.81308411214954,28.333333333333332
35003499,46,265,21,97,1,0,430,38.372093023255815,30.989583333333336
35003505,281,200,21,219,7,38,766,73.89033942558747,58.76288659793815
35003517,153,78,8,28,0,0,267,70.78651685393258,31.57894736842105
35003530,270,281,18,150,3,8,730,61.50684931506849,38.91304347826087
35003542,93,391,20,241,7,0,752,48.00531914893617,40.667678300455236
35003554,51,159,15,78,3,0,306,48.0392156862745,37.64705882352941
35003566,142,190,23,86,0,2,443,57.110609480812634,36.87707641196013
35003585,91,469,17,154,5,1,737,36.36363636363637,27.399380804953566
35003591,166,125,8,61,2,1,363,65.56473829201101,36.54822335025381
35003608,691,905,53,251,11,1,1912,52.66736401673639,25.880425880425882
35003612,157,110,6,52,2,0,327,66.36085626911314,35.29411764705882
35003621,643,250,25,245,19,24,1206,79.2703150912106,55.59502664298401
35003633,133,173,10,77,0,0,393,55.97964376590331,33.46153846153847
35003657,92,248,15,112,2,4,473,47.56871035940803,34.90813648293963
35003669,108,311,9,77,2,0,507,38.65877712031558,22.05513784461153
35003670,455,536,39,170,9,2,1211,55.73905862923204,29.100529100529105
35003682,92,595,59,303,11,0,1060,43.867924528301884,38.53305785123967
35003694,301,686,71,241,27,0,1326,48.265460030165904,33.073170731707314
35003700,83,193,10,47,3,0,336,42.55952380952381,23.715415019762844
35003712,462,549,32,212,4,2,1261,56.463124504361616,31.289111389236545
35003724,219,334,24,160,3,0,740,54.864864864864856,35.89251439539347
35003736,310,118,13,85,0,2,528,77.65151515151516,45.87155963302752
35003748,97,125,10,66,4,1,303,58.745874587458744,39.320388349514566
35003759,449,579,34,248,2,0,1312,55.868902439024396,32.908458864426414
35003773,41,144,17,75,2,0,279,48.38709677419355,39.49579831932773
35003797,259,540,38,136,16,1,990,45.45454545454546,26.128590971272224
35003803,128,100,8,54,1,0,291,65.63573883161511,38.65030674846626
35003815,199,149,8,47,7,0,410,63.65853658536585,29.383886255924175
35003827,630,621,48,212,13,2,1526,59.305373525557,30.691964285714292
35003839,86,142,21,88,1,0,338,57.98816568047338,43.65079365079365
35003840,152,210,19,105,7,1,494,57.48987854251012,38.59649122807017
35003852,473,513,56,227,4,4,1277,59.82772122161315,36.19402985074627
35003864,279,127,18,121,0,0,545,76.69724770642202,52.25563909774436
35003876,131,104,10,56,2,0,303,65.67656765676568,39.53488372093024
35003888,84,258,25,151,2,4,524,50.76335877862596,41.36363636363637
35003897,92,101,14,89,2,0,298,66.10738255033557,50.970873786407765
35003918,111,232,10,141,1,0,495,53.13131313131313,39.583333333333336
35003924,109,424,25,178,3,2,741,42.78002699055331,32.91139240506329
35003931,150,287,24,128,1,2,592,51.52027027027026,35.06787330316742
35003943,345,115,15,82,0,0,557,79.35368043087972,45.75471698113207
35003955,366,364,33,161,4,0,928,60.77586206896552,35.231316725978644
35003967,207,274,9,99,3,0,592,53.71621621621622,28.83116883116883
35003980,74,156,12,72,2,0,316,50.63291139240506,35.537190082644635
35003992,376,106,10,79,0,0,571,81.43607705779334,45.64102564102564
35004001,3,113,0,0,1,0,117,3.4188034188034178,0.8771929824561431
35004002,42,32,1,8,0,1,84,61.904761904761905,23.809523809523814
35004005,283,343,34,348,5,1,1014,66.17357001972385,53.07797537619698
35004015,23,77,5,112,0,0,217,64.51612903225806,60.30927835051547
35004019,82,46,6,18,0,0,152,69.73684210526316,34.285714285714285
35004029,137,104,13,93,1,0,348,70.11494252873563,50.71090047393365
35004030,231,362,48,286,2,2,931,61.117078410311485,48.285714285714285
35004031,111,57,5,78,0,0,251,77.29083665338645,59.285714285714285
35004042,408,262,42,173,1,0,886,70.42889390519187,45.188284518828446
35004049,279,174,31,267,2,0,753,76.89243027888446,63.29113924050633
35004052,34,45,9,111,0,0,199,77.38693467336684,72.72727272727273
35004055,34,30,1,15,0,0,80,62.5,34.78260869565217
35004063,16,31,0,1,0,0,48,35.416666666666664,3.125
35004064,60,106,5,67,1,0,239,55.64853556485356,40.782122905027926
35004066,229,319,24,264,2,2,840,62.023809523809526,47.790507364975454
35004068,112,26,3,21,0,0,162,83.9506172839506,48
35004071,8,31,2,32,6,0,79,60.75949367088608,56.33802816901409
35004072,14,49,7,63,2,0,135,63.70370370370371,59.50413223140496
35004077,113,70,12,80,0,0,275,74.54545454545455,56.790123456790134
35004078,100,200,22,109,4,0,435,54.02298850574713,40.29850746268657
35004085,134,72,6,69,0,0,281,74.37722419928825,51.02040816326531
35004091,228,233,23,171,2,1,658,64.58966565349544,45.81395348837209
35004105,123,46,5,39,1,0,214,78.50467289719626,49.45054945054945
35004107,6,39,4,2,0,0,51,23.529411764705888,13.33333333333333
35004112,159,147,21,136,2,0,465,68.38709677419355,51.96078431372548
35004114,3,84,0,0,1,0,88,4.545454545454541,1.17647058823529
35004116,285,96,10,128,1,1,521,81.57389635316699,59.32203389830508
35004119,69,17,4,73,0,0,163,89.57055214723927,81.91489361702128
35004121,156,565,252,492,14,4,1483,61.90155091031693,57.42275810097966
35004125,93,46,3,9,0,0,151,69.5364238410596,20.68965517241379
35004129,8,26,4,60,0,0,98,73.46938775510203,71.11111111111111
35004130,77,36,2,60,0,1,176,79.54545454545455,63.63636363636363
35004133,226,599,62,423,3,4,1317,54.51784358390282,45.096241979835014
35004134,96,31,2,30,1,0,160,80.625,51.5625
35004145,178,261,27,138,1,1,606,56.93069306930694,39.018691588785046
35004146,77,20,0,3,0,0,100,80,13.043478260869568
35004147,100,52,7,74,0,0,233,77.6824034334764,60.902255639097746
35004148,110,32,4,25,1,0,172,81.3953488372093,48.38709677419355
35004149,114,60,4,38,1,1,218,72.47706422018348,42.307692307692314
35004150,403,92,14,150,1,0,660,86.06060606060606,64.2023346303502
35004151,96,38,4,76,1,0,215,82.32558139534883,68.0672268907563
35004152,48,15,2,14,1,0,80,81.25,53.125
35004153,78,18,1,23,0,0,120,85,57.14285714285714
35004154,143,43,3,6,1,0,196,78.06122448979592,18.867924528301884
35004155,118,23,1,10,0,0,152,84.86842105263158,32.35294117647059
35004156,132,46,7,25,0,0,210,78.0952380952381,41.02564102564102
35004157,87,193,17,59,3,0,359,46.239554317548745,29.04411764705882
35004159,109,25,2,21,1,0,158,84.17721518987342,48.97959183673469
35004160,46,31,2,17,0,0,96,67.70833333333333,38
35004163,7,26,1,14,0,0,48,45.833333333333336,36.58536585365854
35004164,95,48,2,65,0,0,210,77.14285714285715,58.26086956521739
35004165,62,46,2,89,1,0,200,77,66.66666666666667
35004166,49,45,4,66,1,0,165,72.72727272727273,61.206896551724135
35004167,159,30,7,25,1,1,223,86.54708520179372,53.125
35004168,56,15,1,19,0,0,91,83.51648351648352,57.14285714285714
35004169,295,383,27,186,3,3,897,57.30211817168339,36.37873754152824
35004170,126,368,58,258,3,2,815,54.846625766871156,46.58925979680697
35004171,40,45,9,22,1,0,117,61.53846153846154,41.55844155844156
35004172,12,80,0,1,0,0,93,13.978494623655912,1.2345679012345734
35004173,80,43,4,22,0,0,149,71.14093959731544,37.68115942028986
35004174,146,29,3,37,0,0,215,86.51162790697674,57.971014492753625
35004177,120,16,2,12,0,0,150,89.33333333333333,46.666666666666664
35004179,68,51,7,23,0,0,149,65.7718120805369,37.03703703703704
35004180,60,17,0,8,0,0,85,80,31.999999999999996
35004181,42,18,2,13,1,0,76,76.31578947368422,47.05882352941176
35004184,50,30,0,16,0,0,96,68.75,34.78260869565217
35004187,179,33,2,16,0,0,230,85.65217391304347,35.29411764705882
35004188,50,45,1,1,1,0,98,54.08163265306123,6.25
35004189,10,36,2,22,0,0,70,48.57142857142858,40
35004190,20,78,5,13,0,0,116,32.758620689655174,18.75
35004194,262,95,7,92,0,0,456,79.16666666666666,51.03092783505154
35004200,298,161,15,132,1,0,607,73.47611202635915,47.896440129449836
35004212,175,307,39,218,6,2,747,58.90227576974565,46.328671328671334
35004220,58,15,1,19,2,0,95,84.21052631578947,59.45945945945945
35004221,79,31,6,51,1,1,169,81.65680473372781,65.55555555555556
35004222,52,26,0,17,2,0,97,73.1958762886598,42.22222222222223
35004223,77,40,0,14,0,0,131,69.46564885496183,25.92592592592593
35004224,63,180,10,76,2,0,331,45.61933534743202,32.83582089552238
35004225,32,34,0,6,0,0,72,52.77777777777778,15.000000000000002
35004226,165,58,13,66,0,0,302,80.79470198675497,57.664233576642346
35004227,2,54,0,1,0,0,57,5.263157894736848,1.8181818181818188
35004229,72,48,15,22,2,0,159,69.81132075471699,44.827586206896555
35004232,98,34,2,24,1,0,159,78.61635220125787,44.26229508196722
35004234,0,56,0,1,1,0,58,3.4482758620689613,3.4482758620689613
35004236,179,206,14,107,1,0,507,59.368836291913205,37.19512195121951
35004248,204,138,11,75,2,0,430,67.90697674418604,38.93805309734514
35004253,21,15,1,4,0,0,41,63.41463414634146,25
35004259,414,141,12,96,2,0,665,78.796992481203,43.82470119521913
35004263,7,33,0,6,1,0,47,29.78723404255319,17.500000000000004
35004273,342,284,17,173,1,1,818,65.28117359413204,40.33613445378151
35004278,44,9,1,8,1,0,63,85.71428571428572,52.63157894736843
35004285,206,339,19,141,1,0,706,51.98300283286119,32.199999999999996
35004294,96,23,0,22,4,0,145,84.13793103448276,53.06122448979591
35004297,52,333,26,119,2,0,532,37.40601503759399,30.625000000000004
35004303,296,130,23,66,2,2,519,74.95183044315992,41.70403587443946
35004306,11,57,0,7,0,0,75,24,10.9375
35004314,18,68,4,49,0,0,139,51.07913669064747,43.80165289256198
35004315,221,219,21,113,2,0,576,61.97916666666667,38.30985915492958
35004327,471,747,35,314,6,1,1574,52.54129606099111,32.27561196736174
35004338,32,12,0,12,0,0,56,78.57142857142857,50
35004339,246,560,48,346,3,3,1206,53.565505804311776,41.666666666666664
35004340,371,455,38,214,11,3,1092,58.33333333333333,36.89320388349514
35004352,983,1589,122,491,73,5,3263,51.30248237817958,30.30701754385965
35004361,27,20,0,18,0,0,65,69.23076923076923,47.36842105263158
35004362,29,25,4,16,0,1,75,66.66666666666667,45.652173913043484
35004363,49,26,4,22,0,0,101,74.25742574257426,50
35004364,272,357,19,169,2,0,819,56.41025641025641,34.734917733089574
35004365,100,7,0,8,0,0,115,93.91304347826087,53.333333333333336
35004371,1,65,0,1,0,0,67,2.985074626865669,1.5151515151515138
35004374,15,24,6,16,0,0,61,60.65573770491803,47.82608695652174
35004378,29,18,0,2,0,0,49,63.26530612244898,9.999999999999998
35004388,454,851,26,230,3,2,1566,45.65772669220946,23.47122302158273
35004392,164,54,2,14,1,0,235,77.02127659574468,23.943661971830988
35004397,280,240,13,135,0,1,669,64.1255605381166,38.303341902313626
35004406,198,155,12,94,0,0,459,66.23093681917211,40.61302681992337
35004412,141,175,22,129,1,0,468,62.60683760683761,46.48318042813455
35004418,468,556,38,353,2,0,1417,60.762173606210304,41.41201264488936
35004424,271,293,15,109,4,1,693,57.720057720057724,30.568720379146917
35004431,441,581,63,482,3,1,1571,63.01718650541057,48.584070796460175
35004442,5,136,1,3,4,0,149,8.7248322147651,5.555555555555558
35004443,75,169,5,76,0,0,325,48,32.4
35004444,16,28,0,1,0,0,45,37.77777777777778,3.4482758620689613
35004450,36,8,3,5,0,0,52,84.61538461538461,50
35004451,53,11,2,15,0,0,81,86.41975308641976,60.71428571428572
35004455,69,177,6,66,2,0,320,44.6875,29.482071713147405
35004467,78,266,12,112,6,1,475,43.99999999999999,32.99748110831234
35004469,142,52,4,21,2,2,223,76.68161434977578,35.802469135802475
35004479,224,757,34,276,7,0,1298,41.67950693374423,29.51582867783985
35004480,54,228,8,91,0,0,381,40.15748031496062,30.27522935779816
35004492,101,297,20,175,0,1,594,50,39.75659229208925
35004498,65,21,4,15,3,0,108,80.55555555555556,51.162790697674424
35004499,7,28,3,8,2,0,48,41.666666666666664,31.707317073170728
35004500,23,32,0,0,0,0,55,41.81818181818182,0
35004505,7,38,1,6,0,0,52,26.923076923076927,15.555555555555555
35004506,79,31,0,1,0,1,112,72.32142857142857,6.060606060606055
35004508,17,67,1,22,0,0,107,37.383177570093466,25.555555555555554
35004509,80,324,30,145,0,0,579,44.04145077720207,35.07014028056113
35004510,94,180,19,86,1,0,380,52.63157894736843,37.06293706293706
35004511,8,60,2,30,0,0,100,40,34.78260869565217
35004517,47,9,0,0,0,0,56,83.92857142857143,0
35004522,147,390,22,176,2,0,737,47.08276797829036,33.89830508474576
35004524,85,26,5,23,0,0,139,81.29496402877699,51.85185185185186
35004528,35,9,0,3,1,0,48,81.25,30.76923076923077
35004534,478,222,16,148,4,0,868,74.42396313364054,43.07692307692308
35004538,76,27,0,18,1,0,122,77.8688524590164,41.30434782608695
35004541,0,42,0,2,3,0,47,10.63829787234043,10.63829787234043
35004546,190,442,31,219,5,4,891,50.39281705948373,36.947218259629096
35004558,258,143,17,173,4,0,595,75.96638655462185,57.566765578635014
35004561,220,259,28,148,1,0,656,60.518292682926834,40.596330275229356
35004562,6,72,0,1,3,0,82,12.195121951219512,5.263157894736848
35004567,23,35,6,33,0,0,97,63.91752577319587,52.702702702702695
35004568,60,75,2,41,2,0,180,58.33333333333333,37.5
35004571,290,565,23,215,3,0,1096,48.44890510948905,29.900744416873447
35004572,60,23,1,24,1,0,109,78.89908256880733,53.06122448979591
35004575,54,70,7,60,1,1,193,63.730569948186535,49.64028776978417
35004576,43,63,7,35,1,2,151,58.27814569536424,41.666666666666664
35004583,96,144,18,91,1,1,351,58.97435897435898,43.529411764705884
35004595,172,252,32,150,3,0,609,58.62068965517242,42.33409610983981
35004601,238,190,25,122,0,0,575,66.95652173913044,43.62017804154302
35004602,40,13,2,4,0,0,59,77.96610169491525,31.57894736842105
35004608,67,73,14,148,1,0,303,75.9075907590759,69.06779661016948
35004611,76,70,10,74,1,1,232,69.82758620689656,55.12820512820513
35004612,1,32,2,31,0,1,67,52.23880597014925,51.515151515151516
35004613,352,332,52,331,4,1,1072,69.02985074626866,53.888888888888886
35004614,70,60,2,53,0,1,186,67.74193548387098,48.275862068965516
35004625,124,187,21,108,3,0,443,57.787810383747185,41.379310344827594
35004649,306,294,17,193,1,0,811,63.74845869297163,41.78217821782179
35004656,0,55,2,6,0,0,63,12.698412698412698,12.698412698412698
35004662,130,182,11,99,3,0,425,57.1764705882353,38.305084745762706
35004663,23,39,0,18,0,0,80,51.24999999999999,31.57894736842105
35004664,0,56,0,3,3,0,62,9.677419354838712,9.677419354838712
35004670,52,15,0,4,1,0,72,79.16666666666666,25
35004672,7,38,0,6,3,0,54,29.629629629629626,19.14893617021277
35004673,2,44,0,1,0,0,47,6.382978723404253,2.2222222222222254
35004674,433,519,51,429,5,3,1440,63.95833333333334,48.460774577954325
35004682,716,351,45,203,4,0,1319,73.38893100833965,41.7910447761194
35004686,224,237,27,237,0,0,725,67.31034482758619,52.694610778443106
35004693,39,13,0,1,0,0,53,75.47169811320755,7.14285714285714
35004696,61,69,5,24,1,0,160,56.875,30.303030303030297
35004697,35,11,2,24,1,0,73,84.93150684931507,71.05263157894737
35004698,20,47,13,40,2,0,122,61.47540983606557,53.92156862745099
35004699,56,27,4,32,2,1,122,77.8688524590164,59.09090909090908
35004701,57,3,0,0,0,0,60,95,0
35004702,103,45,4,55,1,1,209,78.4688995215311,57.54716981132076
35004704,295,955,85,538,10,1,1884,49.30997876857749,39.899307740717425
35004705,0,69,0,1,4,0,74,6.756756756756754,6.756756756756754
35004707,126,47,8,20,1,0,202,76.73267326732673,38.1578947368421
35004716,13,212,41,171,2,0,439,51.70842824601367,50.23474178403755
35004717,74,24,4,49,0,0,151,84.10596026490066,68.83116883116884
35004718,15,41,8,35,0,0,99,58.58585858585859,51.19047619047619
35004719,24,25,0,12,0,0,61,59.01639344262295,32.432432432432435
35004720,94,40,6,60,0,1,201,80.09950248756219,62.616822429906534
35004721,99,37,4,36,1,0,177,79.09604519774011,52.56410256410257
35004722,83,28,19,67,0,0,197,85.78680203045685,75.43859649122807
35004728,386,232,22,176,2,1,819,71.67277167277167,46.4203233256351
35004732,44,15,4,13,0,0,76,80.26315789473684,53.125
35004736,381,779,73,653,5,1,1892,58.826638477801275,48.44473858371939
35004737,16,64,2,43,0,0,125,48.8,41.28440366972477
35004741,143,352,35,226,3,2,761,53.74507227332457,43.042071197411005
35004742,116,50,0,30,0,0,196,74.48979591836735,37.5
35004743,25,46,4,25,4,0,104,55.769230769230774,41.77215189873418
35004744,189,36,8,50,0,0,283,87.27915194346289,61.702127659574465
35004749,52,29,1,18,0,0,100,71,39.583333333333336
35004751,70,98,5,23,1,0,197,50.25380710659899,22.83464566929134
35004752,331,51,0,35,0,0,417,87.76978417266187,40.69767441860465
35004753,244,228,20,116,4,0,612,62.745098039215684,38.04347826086957
35004765,189,177,14,102,2,1,485,63.50515463917525,40.202702702702695
35004768,95,20,0,2,0,0,117,82.9059829059829,9.090909090909093
35004777,318,518,47,258,7,6,1154,55.11265164644714,38.038277511961724
35004781,69,169,23,227,2,0,490,65.51020408163265,59.857482185273156
35004782,53,45,7,54,0,0,159,71.69811320754718,57.54716981132076
35004783,231,146,15,176,1,0,569,74.34094903339192,56.80473372781065
35004784,94,44,3,34,0,0,175,74.85714285714286,45.67901234567901
35004785,112,169,17,139,0,2,439,61.50341685649203,48.318042813455655
35004786,138,66,7,59,0,1,271,75.64575645756457,50.37593984962406
35004789,91,134,10,56,2,0,293,54.266211604095574,33.66336633663366
35004790,184,312,30,114,11,1,652,52.14723926380368,33.333333333333336
35004791,75,45,2,31,0,0,153,70.58823529411764,42.307692307692314
35004792,185,123,9,281,0,0,598,79.4314381270903,70.2179176755448
35004793,47,51,2,51,0,4,155,67.09677419354838,52.77777777777778
35004796,41,19,1,3,1,0,65,70.76923076923076,20.833333333333336
35004797,36,29,2,12,0,0,79,63.29113924050633,32.55813953488372
35004798,73,29,5,26,0,0,133,78.19548872180451,51.66666666666666
35004799,223,84,1,22,0,0,330,74.54545454545455,21.495327102803742
35004801,20,39,0,3,4,0,66,40.90909090909091,15.217391304347828
35004807,378,749,67,484,8,1,1687,55.601659751037346,42.78074866310161
35004819,157,175,22,80,0,1,435,59.77011494252873,37.05035971223022
35004820,49,112,12,56,3,0,232,51.72413793103448,38.79781420765027
35004832,388,856,67,267,27,1,1606,46.699875466998755,29.720853858784892
35004835,11,142,0,7,3,0,163,12.88343558282209,6.578947368421051
35004836,17,25,1,16,0,0,59,57.6271186440678,40.476190476190474
35004838,19,72,5,53,0,0,149,51.67785234899329,44.61538461538461
35004840,26,45,6,56,0,0,133,66.16541353383458,57.94392523364487
35004842,104,56,2,35,4,2,203,72.41379310344827,43.43434343434344
35004843,127,142,6,66,0,4,345,58.84057971014494,34.862385321100916
35004844,120,138,7,43,0,0,308,55.1948051948052,26.595744680851062
35004845,114,259,9,215,1,1,599,56.761268781302164,46.597938144329895
35004846,84,55,2,19,2,0,162,66.0493827160494,29.487179487179482
35004848,91,22,2,20,0,0,135,83.7037037037037,50
35004854,19,57,0,6,2,0,84,32.14285714285714,12.307692307692308
35004856,98,120,15,75,1,0,309,61.165048543689316,43.127962085308056
35004857,59,32,1,34,1,0,127,74.80314960629921,52.94117647058824
35004858,14,56,1,1,1,0,73,23.28767123287672,5.0847457627118615
35004859,118,110,5,35,0,0,268,58.95522388059702,26.66666666666667
35004860,52,19,1,13,1,0,86,77.90697674418605,44.11764705882353
35004865,116,300,13,52,1,2,484,38.01652892561983,18.478260869565222
35004866,153,47,16,56,0,0,272,82.72058823529412,60.504201680672274
35004867,18,34,4,46,2,0,104,67.3076923076923,60.46511627906976
35004868,433,496,56,584,3,0,1572,68.44783715012723,56.453028972783144
35004869,81,22,0,8,0,0,111,80.18018018018019,26.66666666666667
35004873,78,187,11,74,3,0,353,47.02549575070821,31.999999999999996
35004881,354,227,36,303,0,0,920,75.32608695652175,59.8939929328622
35004893,92,179,12,68,0,1,352,49.14772727272727,31.153846153846153
35004900,624,262,28,200,0,0,1114,76.48114901256733,46.53061224489796
35004911,164,386,24,245,0,1,820,52.926829268292686,41.15853658536586
35004919,69,8,0,0,0,0,77,89.6103896103896,0
35004923,371,648,87,587,5,1,1699,61.8599175985874,51.20481927710843
35004933,16,68,0,5,0,0,89,23.59550561797753,6.849315068493156
35004935,20,300,47,279,5,0,651,53.91705069124424,52.45641838351822
35004947,98,449,44,533,1,0,1125,60.08888888888888,56.28042843232717
35004959,377,157,13,129,2,0,678,76.84365781710915,47.840531561461795
35004960,394,365,29,286,1,1,1076,66.07806691449814,46.48093841642229
35004963,558,172,38,198,2,0,968,82.23140495867769,58.04878048780488
35004964,36,113,3,3,4,2,161,29.81366459627329,9.599999999999998
35004970,58,0,0,0,0,0,58,100,NaN
35004971,4,57,3,12,0,0,76,25,20.833333333333336
35004972,217,152,11,104,1,0,485,68.65979381443299,43.28358208955224
35004973,4,78,0,1,1,0,84,7.14285714285714,2.500000000000002
35004984,321,566,49,319,6,3,1264,55.22151898734178,39.978791092258746
35004991,74,307,2,6,6,0,395,22.278481012658226,4.361370716510904
35004996,217,327,37,288,1,1,871,62.4569460390356,50
35005001,10,174,2,14,5,0,205,15.121951219512198,10.769230769230765
35005009,295,362,44,385,3,0,1089,66.7584940312213,54.408060453400495
35005010,319,713,68,467,4,5,1576,54.758883248730974,43.27764518695306
35005022,456,232,26,165,2,1,882,73.69614512471657,45.539906103286384
35005029,19,26,4,15,0,0,64,59.375,42.22222222222223
35005033,25,24,3,22,0,0,74,67.56756756756756,51.02040816326531
35005034,397,674,53,512,2,2,1640,58.902439024390254,45.77634754625905
35005035,75,64,10,112,0,0,261,75.47892720306514,65.59139784946237
35005036,152,18,2,51,0,0,223,91.92825112107623,74.64788732394366
35005042,48,12,2,15,0,0,77,84.4155844155844,58.62068965517242
35005043,26,20,4,14,0,0,64,68.75,47.36842105263158
35005044,105,26,3,11,2,0,147,82.31292517006803,38.095238095238095
35005045,96,42,3,42,0,0,183,77.04918032786885,51.72413793103448
35005046,247,372,67,414,0,0,1100,66.18181818181819,56.38921453692849
35005047,2,42,0,0,0,0,44,4.545454545454541,0
35005048,6,55,0,0,0,0,61,9.836065573770492,0
35005049,41,12,2,25,0,0,80,85,69.23076923076923
35005058,392,160,21,136,1,3,713,77.55960729312763,50.155763239875384
35005061,268,410,42,301,10,2,1033,60.309777347531465,46.40522875816993
35005067,204,79,3,128,0,0,414,80.91787439613528,62.38095238095238
35005068,40,19,4,34,0,0,97,80.41237113402062,66.66666666666667
35005069,92,39,6,28,1,0,166,76.50602409638554,47.297297297297305
35005071,383,381,41,269,5,2,1081,64.75485661424607,45.41547277936962
35005073,86,25,2,78,0,0,191,86.91099476439791,76.19047619047619
35005074,46,28,0,17,1,2,94,70.2127659574468,41.666666666666664
35005076,53,45,3,73,4,2,180,75,64.56692913385827
35005078,96,49,8,41,1,0,195,74.87179487179488,50.5050505050505
35005079,92,44,13,74,1,1,225,80.44444444444444,66.9172932330827
35005080,59,12,0,34,0,0,105,88.57142857142857,73.91304347826086
35005081,16,20,0,16,0,0,52,61.53846153846154,44.44444444444444
35005082,98,93,7,53,1,0,252,63.095238095238095,39.6103896103896
35005083,189,440,27,199,1,2,858,48.71794871794872,34.23019431988041
35005084,151,44,7,27,0,1,230,80.8695652173913,44.30379746835443
35005086,80,22,2,14,0,0,118,81.35593220338984,42.10526315789473
35005087,44,31,1,19,0,0,95,67.36842105263158,39.21568627450981
35005095,513,417,63,404,2,2,1401,70.2355460385439,53.04054054054055
35005098,50,18,1,8,1,0,78,76.92307692307692,35.71428571428571
35005099,175,61,2,53,3,1,295,79.3220338983051,49.16666666666667
35005100,111,50,3,86,0,1,251,80.0796812749004,64.28571428571428
35005102,197,128,7,39,1,0,372,65.59139784946237,26.857142857142858
35005103,97,47,4,94,0,0,242,80.57851239669421,67.58620689655173
35005104,105,40,3,77,1,0,226,82.30088495575221,66.94214876033058
35005105,42,22,4,64,0,0,132,83.33333333333334,75.55555555555556
35005106,23,82,9,128,1,1,244,66.39344262295081,62.89592760180995
35005107,169,13,3,44,0,0,229,94.32314410480349,78.33333333333333
35005108,78,76,3,44,1,0,202,62.37623762376238,38.70967741935484
35005109,22,58,9,106,0,0,195,70.25641025641025,66.47398843930637
35005110,152,172,10,23,4,0,361,52.35457063711911,17.703349282296653
35005112,83,21,3,44,1,0,152,86.18421052631578,69.56521739130434
35005113,470,684,82,555,6,4,1801,62.021099389228205,48.610067618332074
35005115,47,149,4,10,0,0,210,29.047619047619044,8.588957055214719
35005118,29,35,3,21,2,0,90,61.111111111111114,42.622950819672134
35005119,8,103,11,80,0,0,202,49.00990099009901,46.90721649484536
35005125,168,175,18,145,0,0,506,65.41501976284584,48.22485207100592
35005127,52,29,0,21,0,0,102,71.56862745098039,42.00000000000001
35005128,61,16,0,3,0,0,80,80,15.789473684210531
35005129,54,41,5,36,0,1,137,70.07299270072993,50.60240963855422
35005130,15,22,0,19,0,0,56,60.71428571428572,46.34146341463414
35005135,62,31,8,23,0,0,124,75,50
35005137,324,800,58,410,4,2,1598,49.93742177722152,37.20565149136578
35005138,63,39,5,32,0,0,139,71.94244604316546,48.68421052631579
35005141,40,64,1,2,0,0,107,40.186915887850475,4.477611940298509
35005142,112,29,2,15,0,0,158,81.64556962025317,36.95652173913043
35005143,64,9,3,4,0,0,80,88.75,43.75
35005144,75,31,1,25,1,0,133,76.69172932330828,46.55172413793104
35005145,46,31,6,22,0,0,105,70.47619047619047,47.45762711864406
35005146,36,17,0,12,0,0,65,73.84615384615385,41.379310344827594
35005149,183,535,58,394,8,1,1179,54.6225614927905,46.285140562249
35005150,271,208,16,158,3,0,656,68.29268292682926,45.97402597402598
35005151,48,31,0,17,1,1,98,68.36734693877551,38
35005153,6,36,0,0,0,0,42,14.28571428571429,0
35005154,22,34,0,0,0,0,56,39.28571428571429,0
35005155,19,11,1,22,1,0,54,79.62962962962963,68.57142857142857
35005162,323,722,55,449,5,6,1560,53.717948717948715,41.63298302344381
35005163,57,27,9,41,5,2,141,80.85106382978724,67.85714285714286
35005169,196,74,6,38,1,0,315,76.5079365079365,37.81512605042017
35005170,72,46,2,20,0,0,140,67.14285714285715,32.35294117647059
35005174,207,291,14,108,3,0,623,53.29052969502408,30.048076923076927
35005177,67,41,4,16,1,0,129,68.21705426356588,33.87096774193549
35005178,14,81,1,46,0,0,142,42.95774647887324,36.71875
35005180,32,31,2,49,0,0,114,72.80701754385966,62.19512195121951
35005181,101,130,3,23,0,0,257,49.416342412451364,16.666666666666664
35005182,3,60,0,3,3,0,69,13.043478260869568,9.090909090909093
35005184,31,41,1,30,1,0,104,60.57692307692308,43.83561643835616
35005185,79,8,0,0,1,0,88,90.9090909090909,11.111111111111116
35005186,57,554,40,393,0,0,1044,46.93486590038314,43.87031408308004
35005187,42,42,4,130,2,0,220,80.9090909090909,76.40449438202246
35005188,61,26,0,23,1,0,111,76.57657657657657,48
35005189,145,70,7,56,2,2,282,75.177304964539,48.90510948905109
35005190,16,42,1,17,0,0,76,44.73684210526315,30.000000000000004
35005193,5,113,5,168,1,0,292,61.3013698630137,60.62717770034843
35005198,511,664,54,423,7,1,1660,60,42.210617928633596
35005200,61,39,8,27,1,1,137,71.53284671532847,48.68421052631579
35005201,173,42,4,194,0,0,413,89.83050847457628,82.5
35005202,75,43,6,24,2,0,150,71.33333333333334,42.666666666666664
35005203,163,90,11,89,0,0,353,74.5042492917847,52.63157894736843
35005204,334,436,64,459,4,1,1298,66.40986132511556,54.77178423236515
35005205,42,25,2,9,1,0,79,68.35443037974683,32.432432432432435
35005206,50,40,2,17,0,0,109,63.30275229357798,32.20338983050848
35005207,86,55,1,26,3,0,171,67.83625730994152,35.29411764705882
35005210,196,42,8,29,0,0,275,84.72727272727273,46.83544303797469
35005211,72,18,1,13,0,0,104,82.6923076923077,43.75
35005212,47,57,5,35,2,1,147,61.224489795918366,43.00000000000001
35005213,89,31,4,32,1,0,157,80.2547770700637,54.41176470588236
35005214,54,10,2,14,0,0,80,87.5,61.53846153846154
35005216,201,645,59,268,6,1,1180,45.33898305084746,34.116445352400405
35005218,72,28,2,17,0,0,119,76.47058823529412,40.42553191489362
35005219,0,43,0,0,0,0,43,0,0
35005220,3,50,0,0,0,0,53,5.660377358490565,0
35005221,46,37,0,10,2,0,95,61.05263157894737,24.489795918367353
35005222,78,27,0,10,1,0,116,76.72413793103449,28.947368421052634
35005223,52,31,3,22,0,0,108,71.2962962962963,44.64285714285714
35005224,82,48,4,57,1,2,194,75.25773195876289,57.14285714285714
35005225,10,33,3,28,0,0,74,55.4054054054054,48.4375
35005226,47,9,0,11,0,0,67,86.56716417910448,55.00000000000001
35005228,183,256,41,195,2,5,682,62.4633431085044,48.697394789579164
35005229,2,65,0,5,7,0,79,17.721518987341767,15.58441558441559
35005232,78,38,4,35,0,0,155,75.48387096774194,50.64935064935065
35005234,150,26,3,30,1,0,210,87.61904761904762,56.666666666666664
35005235,38,22,3,16,0,0,79,72.15189873417722,46.34146341463414
35005236,57,487,42,597,1,0,1184,58.86824324324324,56.78793256433008
35005237,67,44,2,7,0,0,120,63.33333333333333,16.981132075471695
35005238,50,52,0,13,0,0,115,54.78260869565217,19.999999999999996
35005239,62,88,13,112,2,0,277,68.23104693140793,59.06976744186046
35005241,361,625,58,489,3,0,1536,59.30989583333333,46.808510638297875
35005242,246,169,20,226,2,0,663,74.50980392156863,59.47242206235013
35005243,18,14,3,77,8,0,120,88.33333333333333,86.27450980392157
35005248,64,41,1,9,3,0,118,65.2542372881356,24.07407407407407
35005253,47,355,37,480,0,0,919,61.37105549510338,59.28899082568808
35005255,98,28,0,13,0,1,140,80,33.333333333333336
35005256,3,62,0,0,0,0,65,4.61538461538461,0
35005257,17,53,6,23,1,0,100,47,36.14457831325302
35005258,94,84,4,30,0,0,212,60.37735849056604,28.8135593220339
35005259,9,63,4,71,0,0,147,57.14285714285714,54.347826086956516
35005260,54,10,1,13,1,0,79,87.34177215189874,60
35005262,87,7,1,0,1,0,96,92.70833333333334,22.22222222222222
35005264,85,51,4,33,2,0,175,70.85714285714286,43.333333333333336
35005265,129,642,120,757,0,3,1651,61.114476075106,57.81865965834429
35005266,18,39,3,42,0,0,102,61.76470588235294,53.57142857142857
35005268,93,65,1,16,0,0,175,62.857142857142854,20.731707317073166
35005269,224,129,17,227,6,1,604,78.64238410596026,66.05263157894737
35005270,64,80,5,206,0,2,357,77.59103641456583,72.69624573378839
35005271,83,69,1,71,2,0,226,69.46902654867257,51.74825174825175
35005273,128,34,4,79,2,0,247,86.23481781376519,71.42857142857143
35005274,54,84,10,149,3,0,300,72,65.85365853658536
35005275,44,19,4,13,0,0,80,76.25,47.22222222222222
35005277,195,394,25,270,0,0,884,55.42986425339367,42.81567489114659
35005279,19,67,0,0,1,0,87,22.988505747126442,1.4705882352941124
35005280,83,32,5,11,1,0,132,75.75757575757575,34.693877551020414
35005281,10,134,2,99,6,1,252,46.82539682539682,44.628099173553714
35005282,77,15,1,20,0,0,113,86.72566371681415,58.33333333333333
35005284,58,29,3,28,0,0,118,75.42372881355932,51.66666666666666
35005289,181,562,34,283,3,7,1070,47.476635514018696,36.782902137232846
35005290,408,454,56,390,3,4,1315,65.47528517110266,49.94487320837927
35005294,85,23,1,22,0,0,131,82.44274809160305,50
35005295,71,25,9,28,0,0,133,81.203007518797,59.67741935483871
35005296,68,24,3,32,0,1,128,81.25,60
35005297,35,30,2,13,0,0,80,62.5,33.333333333333336
35005298,43,20,4,6,7,0,80,75,45.945945945945944
35005299,52,24,1,14,0,0,91,73.62637362637363,38.46153846153846
35005300,77,26,2,17,0,0,122,78.68852459016394,42.22222222222223
35005301,82,33,5,28,0,0,148,77.7027027027027,50
35005302,75,14,2,26,0,0,117,88.03418803418803,66.66666666666667
35005303,96,24,6,30,1,0,157,84.71337579617835,60.65573770491803
35005305,4,37,3,3,0,0,47,21.276595744680847,13.953488372093027
35005307,184,645,88,572,3,5,1497,56.91382765531062,50.875856816450884
35005308,41,22,1,12,2,0,78,71.7948717948718,40.54054054054054
35005309,61,115,4,20,1,1,202,43.069306930693074,18.439716312056742
35005310,46,34,5,44,0,0,129,73.64341085271317,59.036144578313255
35005311,112,30,5,35,1,0,183,83.60655737704919,57.74647887323944
35005312,67,6,1,5,0,0,79,92.40506329113924,50
35005313,92,74,3,40,1,5,215,65.5813953488372,39.83739837398373
35005314,80,19,2,13,0,0,114,83.33333333333334,44.11764705882353
35005315,23,23,2,21,0,0,69,66.66666666666667,50
35005316,109,35,10,37,2,0,193,81.86528497409327,58.33333333333333
35005317,33,17,3,37,2,1,93,81.72043010752688,71.66666666666667
35005318,67,47,6,24,1,0,145,67.58620689655173,39.743589743589745
35005319,317,215,13,270,1,0,816,73.65196078431373,56.91382765531062
35005320,328,326,54,381,2,4,1095,70.22831050228311,57.496740547588
35005322,48,19,4,7,2,0,80,76.25,40.625
35005323,72,46,0,52,0,0,170,72.94117647058825,53.06122448979591
35005324,71,41,2,21,0,0,135,69.62962962962963,35.9375
35005326,35,95,9,33,0,0,172,44.76744186046512,30.65693430656934
35005327,64,88,9,76,2,0,239,63.179916317991626,49.71428571428571
35005329,39,27,4,23,0,0,93,70.96774193548387,50
35005330,55,32,4,14,0,0,105,69.52380952380952,36
35005332,375,93,9,95,5,1,578,83.91003460207612,54.187192118226605
35005335,59,20,0,7,0,0,86,76.74418604651163,25.92592592592593
35005337,39,22,0,15,0,0,76,71.05263157894737,40.54054054054054
35005344,43,619,45,531,3,0,1241,50.12087026591458,48.33055091819699
35005351,76,13,0,3,0,0,92,85.86956521739131,18.75
35005352,76,50,1,24,1,0,152,67.10526315789474,34.210526315789465
35005353,108,43,1,84,0,0,236,81.77966101694916,66.40625
35005356,127,512,46,291,4,0,980,47.755102040816325,39.97655334114889
35005359,0,48,2,4,0,0,54,11.111111111111116,11.111111111111116
35005360,50,27,0,18,1,0,96,71.875,41.30434782608695
35005362,63,32,2,39,2,0,138,76.81159420289855,57.33333333333333
35005366,59,0,0,0,0,0,59,100,NaN
35005368,309,773,62,484,8,4,1640,52.86585365853659,41.92336589030804
35005370,48,34,1,29,3,0,115,70.43478260869564,49.25373134328358
35005371,62,24,0,25,0,0,111,78.37837837837837,51.02040816326531
35005373,41,224,33,156,1,1,456,50.877192982456144,46.024096385542165
35005381,210,345,29,283,2,2,871,60.39035591274398,47.806354009077154
35005389,80,40,3,14,1,0,138,71.01449275362319,31.034482758620683
35005393,448,316,52,526,3,0,1345,76.50557620817844,64.77146042363432
35005397,36,77,7,34,0,0,154,50,34.7457627118644
35005400,330,602,41,431,2,1,1407,57.2139303482587,44.10399257195915
35005411,499,534,82,819,3,8,1945,72.54498714652956,63.07053941908713
35005417,8,55,0,12,0,0,75,26.66666666666667,17.910447761194025
35005418,13,30,0,0,0,0,43,30.23255813953488,0
35005423,282,110,9,140,0,0,541,79.66728280961183,57.52895752895753
35005424,63,18,0,19,6,0,106,83.01886792452831,58.13953488372092
35005426,48,23,1,18,0,0,90,74.44444444444444,45.238095238095234
35005427,60,28,0,39,0,0,127,77.95275590551181,58.2089552238806
35005431,131,31,4,42,1,0,209,85.16746411483254,60.25641025641026
35005432,31,79,7,138,3,0,258,69.37984496124031,65.19823788546255
35005433,30,121,17,198,0,1,367,67.0299727520436,64.09495548961424
35005435,191,454,36,358,2,0,1041,56.388088376560994,46.58823529411765
35005438,69,2,0,1,0,0,72,97.22222222222221,33.333333333333336
35005439,32,36,6,29,0,0,103,65.04854368932038,49.29577464788733
35005441,44,14,0,10,0,0,68,79.41176470588236,41.666666666666664
35005442,157,54,8,28,0,0,247,78.13765182186233,40
35005445,22,18,4,22,0,0,66,72.72727272727273,59.09090909090908
35005446,52,62,9,53,0,0,176,64.77272727272727,50
35005447,112,226,23,249,3,2,615,63.25203252032521,55.069582504970185
35005449,40,30,5,39,0,0,114,73.6842105263158,59.45945945945945
35005450,142,74,7,26,1,0,250,70.39999999999999,31.481481481481477
35005452,40,15,1,14,0,0,70,78.57142857142857,50
35005459,232,409,31,389,0,2,1063,61.52398871119473,50.782190132370644
35005460,231,113,22,130,1,0,497,77.2635814889336,57.5187969924812
35005463,40,20,0,9,1,0,70,71.42857142857143,33.333333333333336
35005465,1,37,0,2,5,0,45,17.777777777777782,15.909090909090907
35005468,58,60,3,32,1,0,154,61.038961038961034,37.5
35005472,123,142,10,138,1,0,414,65.70048309178745,51.20274914089347
35005474,59,37,3,24,0,0,123,69.91869918699187,42.1875
35005484,298,426,59,406,1,2,1192,64.26174496644295,52.348993288590606
35005486,118,56,5,56,0,1,236,76.27118644067797,52.542372881355924
35005488,113,16,2,60,0,0,191,91.62303664921467,79.48717948717949
35005491,22,29,3,23,2,1,80,63.74999999999999,50
35005492,12,69,3,30,2,1,117,41.02564102564102,34.285714285714285
35005493,36,32,1,22,1,0,92,65.21739130434783,42.85714285714286
35005495,7,60,3,89,0,0,159,62.264150943396224,60.526315789473685
35005497,35,25,1,18,0,0,79,68.35443037974683,43.18181818181818
35005498,49,52,4,48,2,1,156,66.66666666666667,51.4018691588785
35005499,98,45,7,42,1,0,193,76.6839378238342,52.63157894736843
35005500,36,48,4,60,0,0,148,67.56756756756756,57.14285714285714
35005503,4,151,0,50,2,2,209,27.751196172248804,26.34146341463415
35005505,27,35,7,70,0,0,139,74.82014388489209,68.75
35005506,56,26,0,23,0,1,106,75.47169811320755,48
35005507,51,28,2,28,0,0,109,74.31192660550458,51.72413793103448
35005510,162,156,10,129,1,0,458,65.93886462882097,47.297297297297305
35005511,6,34,3,49,0,0,92,63.04347826086957,60.46511627906976
35005512,167,67,6,65,1,3,309,78.31715210355988,52.816901408450704
35005515,50,14,2,13,0,0,79,82.27848101265822,51.72413793103448
35005516,57,55,6,37,0,0,155,64.51612903225806,43.87755102040817
35005518,49,18,0,21,1,0,89,79.7752808988764,55.00000000000001
35005519,59,7,1,1,2,0,70,90,36.36363636363637
35005520,18,37,1,13,0,2,71,47.887323943661976,30.188679245283023
35005523,66,51,1,70,3,0,191,73.29842931937172,59.20000000000001
35005528,21,29,1,27,1,1,80,63.74999999999999,50.847457627118644
35005529,138,54,3,55,0,0,250,78.4,51.78571428571428
35005530,39,39,5,31,0,3,117,66.66666666666667,50
35005533,90,37,4,76,0,0,207,82.1256038647343,68.37606837606837
35005535,48,43,4,43,1,0,139,69.06474820143885,52.74725274725275
35005537,109,31,7,19,0,0,166,81.32530120481928,45.614035087719294
35005540,158,81,7,71,0,0,317,74.44794952681389,49.056603773584904
35005541,61,30,3,16,0,0,110,72.72727272727273,38.775510204081634
35005542,24,21,2,31,1,0,79,73.41772151898735,61.81818181818181
35005543,27,19,1,18,0,0,65,70.76923076923076,50
35005546,8,31,0,0,4,0,43,27.906976744186053,11.428571428571432
35005547,99,31,2,37,0,0,169,81.65680473372781,55.714285714285715
35005549,76,25,2,47,0,0,150,83.33333333333334,66.21621621621621
35005550,22,39,7,34,1,0,103,62.13592233009708,51.85185185185186
35005554,45,73,1,30,2,4,155,52.903225806451616,33.63636363636363
35005555,194,21,2,19,0,0,236,91.10169491525424,50
35005556,89,135,18,22,6,10,280,51.78571428571428,29.31937172774869
35005557,119,36,4,18,0,0,177,79.66101694915254,37.93103448275862
35005559,45,31,1,25,3,1,106,70.75471698113208,49.18032786885246
35005564,0,63,3,32,0,0,98,35.71428571428571,35.71428571428571
35005565,55,51,9,35,1,0,151,66.22516556291392,46.875
35005566,52,70,4,7,1,0,134,47.76119402985075,14.634146341463417
35005569,6,31,1,4,1,1,44,29.54545454545454,18.42105263157895
35005574,9,41,0,4,1,0,55,25.454545454545453,10.869565217391308
35005576,118,18,2,19,0,0,157,88.53503184713377,53.84615384615385
35005577,101,52,2,21,3,0,179,70.94972067039106,33.333333333333336
35005578,12,52,4,49,0,0,117,55.55555555555556,50.476190476190474
35005579,69,29,0,29,1,1,129,77.51937984496125,51.66666666666666
35005580,35,65,4,51,0,0,155,58.06451612903225,45.833333333333336
35005585,45,38,0,13,1,0,97,60.82474226804124,26.923076923076927
35005586,47,19,3,31,0,0,100,81,64.15094339622642
35005588,57,25,7,26,0,0,115,78.26086956521739,56.896551724137936
35005589,58,21,0,13,0,0,92,77.17391304347827,38.23529411764706
35005590,44,40,3,11,0,0,98,59.183673469387756,25.92592592592593
35005591,51,24,2,11,0,0,88,72.72727272727273,35.13513513513513
35005592,74,30,1,16,1,0,122,75.40983606557377,37.5
35005593,41,12,1,16,0,0,70,82.85714285714285,58.62068965517242
35005594,264,491,2,6,13,0,776,36.72680412371135,4.1015625
35005595,103,43,0,14,0,0,160,73.125,24.561403508771928
35005598,30,35,5,33,1,0,104,66.34615384615384,52.702702702702695
35005601,72,96,7,136,1,1,313,69.32907348242811,60.165975103734446
35005603,85,72,5,29,0,0,191,62.30366492146597,32.07547169811321
35005604,136,43,2,13,0,0,194,77.83505154639175,25.86206896551724
35005607,22,7,1,23,0,0,53,86.79245283018868,77.41935483870968
35005608,95,54,8,37,1,0,195,72.3076923076923,46
35005611,44,61,1,8,1,0,115,46.95652173913043,14.084507042253524
35005612,35,9,0,18,0,0,62,85.48387096774194,66.66666666666667
35005618,31,18,3,15,0,0,67,73.13432835820896,50
35005625,69,34,7,22,0,0,132,74.24242424242425,46.03174603174603
35005628,58,12,0,1,2,0,73,83.56164383561644,19.999999999999996
35005631,29,67,5,22,0,0,123,45.52845528455285,28.723404255319153
35005632,100,41,2,28,0,0,171,76.0233918128655,42.25352112676056
35005636,58,43,1,15,1,0,118,63.55932203389831,28.333333333333332
35005641,461,146,14,102,3,0,726,79.88980716253444,44.905660377358494
35005643,41,51,4,37,0,0,133,61.654135338345874,44.565217391304344
35005644,53,24,5,27,0,0,109,77.98165137614679,57.14285714285714
35005647,37,7,3,33,0,0,80,91.25,83.72093023255813
35005648,55,36,3,99,0,0,193,81.34715025906736,73.91304347826086
35005649,35,30,10,36,1,0,112,73.21428571428572,61.038961038961034
35005669,53,63,4,44,2,5,171,63.1578947368421,46.61016949152542
35005671,35,41,1,0,0,0,77,46.753246753246756,2.3809523809523836
35005672,19,57,0,1,0,0,77,25.97402597402597,1.7241379310344862
35005682,2,49,0,1,0,0,52,5.769230769230771,2.0000000000000018
35005683,57,48,2,40,1,0,148,67.56756756756756,47.25274725274725
35005687,93,30,3,43,1,0,170,82.35294117647058,61.038961038961034
35005689,42,16,0,22,0,0,80,80,57.89473684210527
35005690,19,31,0,29,0,1,80,61.25000000000001,49.18032786885246
35005696,55,49,2,27,2,0,135,63.70370370370371,38.74999999999999
35005697,80,71,2,83,0,0,236,69.91525423728814,54.487179487179496
35005698,64,27,2,23,2,0,118,77.11864406779661,50
35005699,74,39,3,25,2,0,143,72.72727272727273,43.47826086956522
35005700,44,30,2,19,1,1,97,69.0721649484536,43.39622641509434
35005701,49,20,3,37,0,0,109,81.65137614678899,66.66666666666667
35005703,62,27,1,18,0,0,108,75,41.30434782608695
35005704,73,45,6,27,0,1,152,70.39473684210526,43.0379746835443
35005705,48,0,0,0,0,0,48,100,NaN
35005711,39,70,6,13,0,0,128,45.3125,21.34831460674157
35005713,11,140,12,89,0,0,252,44.44444444444444,41.90871369294605
35005715,7,63,2,30,0,0,102,38.23529411764706,33.684210526315795
35005717,39,28,1,12,0,0,80,65,31.707317073170728
35005718,120,45,5,43,1,0,214,78.97196261682244,52.127659574468076
35005719,13,58,4,110,2,0,187,68.98395721925134,66.66666666666667
35005720,63,52,9,97,1,0,222,76.57657657657657,67.29559748427674
35005722,143,124,10,102,2,1,382,67.5392670157068,48.11715481171548
35005723,128,103,11,126,3,0,371,72.23719676549865,57.61316872427984
35005724,71,128,14,100,0,1,314,59.23566878980891,47.325102880658434
35005725,61,24,2,29,1,0,117,79.48717948717949,57.14285714285714
35005726,62,36,5,14,0,0,117,69.23076923076923,34.54545454545455
35005727,44,41,5,37,0,2,129,68.21705426356588,51.764705882352935
35005729,4,42,11,17,23,0,97,56.70103092783505,54.83870967741935
35005730,120,83,1,79,0,0,283,70.6713780918728,49.079754601227
35005731,78,73,2,33,0,0,186,60.752688172043015,32.407407407407405
35005732,55,13,0,20,1,0,89,85.39325842696628,61.76470588235294
35005734,32,33,1,20,0,0,86,61.627906976744185,38.888888888888886
35005735,22,26,0,20,0,0,68,61.76470588235294,43.47826086956522
35005736,55,21,6,16,0,0,98,78.57142857142857,51.162790697674424
35005737,8,41,1,11,0,0,61,32.786885245901644,22.64150943396226
35005738,55,16,0,14,1,0,86,81.3953488372093,48.38709677419355
35005739,10,90,5,29,1,0,135,33.333333333333336,28.000000000000004
35005743,36,29,3,50,1,1,120,75.83333333333333,65.47619047619048
35005749,13,27,3,33,0,0,76,64.47368421052632,57.14285714285714
35005751,126,31,3,21,1,0,182,82.96703296703296,44.64285714285714
35005752,19,24,2,17,0,6,68,64.70588235294117,51.02040816326531
35005754,1,54,2,39,0,0,96,43.75,43.15789473684211
35005755,7,51,0,1,0,0,59,13.559322033898303,1.9230769230769273
35005759,18,41,0,9,0,0,68,39.70588235294118,18.000000000000004
35005760,38,29,3,18,0,0,88,67.04545454545455,42.00000000000001
35005762,48,49,3,14,1,0,115,57.391304347826086,26.865671641791046
35005763,65,6,0,0,0,0,71,91.54929577464789,0
35005765,21,44,7,62,0,0,134,67.16417910447761,61.061946902654874
35005766,18,52,5,92,0,0,167,68.8622754491018,65.1006711409396
35005767,56,22,1,49,0,0,128,82.8125,69.44444444444444
35005768,90,39,8,53,0,0,190,79.47368421052632,61
35005771,1,114,0,0,0,0,115,0.8695652173912993,0
35005773,61,39,3,39,0,1,143,72.72727272727273,52.4390243902439
35005774,14,40,9,96,0,1,160,75,72.6027397260274
35005775,68,16,3,33,2,0,122,86.88524590163934,70.37037037037037
35005776,51,39,5,21,2,0,118,66.94915254237289,41.7910447761194
35005777,26,92,12,138,0,0,268,65.67164179104478,61.98347107438016
35005778,51,15,3,31,0,0,100,85,69.38775510204081
35005781,13,42,0,33,0,0,88,52.27272727272727,43.99999999999999
35005784,33,32,1,26,0,0,92,65.21739130434783,45.76271186440678
35005795,10,120,1,0,0,0,131,8.3969465648855,0.8264462809917328
35005799,39,20,1,20,0,0,80,75,51.21951219512195
35005801,53,49,2,20,3,0,127,61.417322834645674,33.78378378378378
35005816,11,34,1,5,4,0,55,38.18181818181819,22.72727272727273
35005819,40,22,4,24,1,1,92,76.08695652173914,57.692307692307686
35005820,28,26,3,31,1,0,89,70.78651685393258,57.377049180327866
35005828,21,38,2,13,0,0,74,48.64864864864865,28.301886792452834
35005829,240,118,13,98,0,2,471,74.94692144373674,48.917748917748916
35005831,17,28,2,31,0,0,78,64.1025641025641,54.0983606557377
35005834,53,22,0,10,0,1,86,74.4186046511628,33.333333333333336
35005841,7,54,0,1,0,0,62,12.903225806451612,1.8181818181818188
35005843,166,54,9,78,0,0,307,82.41042345276874,61.702127659574465
35005845,101,30,6,37,0,0,174,82.75862068965517,58.9041095890411
35005852,43,58,3,98,0,1,203,71.42857142857143,63.74999999999999
35005865,41,123,8,63,2,0,237,48.10126582278481,37.244897959183675
35005869,33,19,1,13,1,0,67,71.64179104477613,44.11764705882353
35005876,21,44,4,106,0,0,175,74.85714285714286,71.42857142857143
35005879,56,43,5,48,1,0,153,71.89542483660131,55.670103092783506
35005880,33,58,7,66,0,0,164,64.63414634146342,55.72519083969465
35005881,28,17,6,16,2,0,69,75.36231884057972,58.53658536585367
35005882,25,30,3,12,2,0,72,58.33333333333333,36.170212765957444
35005886,186,46,12,37,1,5,287,83.97212543554006,54.45544554455446
35005887,40,31,4,23,0,0,98,68.36734693877551,46.55172413793104
35005889,23,56,5,24,0,0,108,48.14814814814815,34.11764705882353
35005891,14,19,0,31,0,0,64,70.3125,62
35005894,133,81,7,86,0,0,307,73.61563517915309,53.448275862068975
35005895,105,89,8,110,2,1,315,71.74603174603175,57.61904761904761
35005896,52,26,2,19,0,0,99,73.73737373737373,44.680851063829785
35005905,45,39,1,14,0,0,99,60.60606060606061,27.77777777777778
35005906,37,19,3,37,2,0,98,80.61224489795919,68.85245901639344
35005911,37,26,1,3,0,0,67,61.19402985074627,13.33333333333333
35005916,46,44,2,25,0,0,117,62.39316239316239,38.02816901408451
35005917,36,29,1,13,0,0,79,63.29113924050633,32.55813953488372
35005919,11,36,1,26,1,1,76,52.63157894736843,44.61538461538461
35005920,10,42,2,3,0,0,57,26.315789473684216,10.63829787234043
35005923,20,28,1,30,0,0,79,64.55696202531645,52.542372881355924
35005924,31,24,1,24,0,0,80,70,51.02040816326531
35005929,26,53,3,28,0,0,110,51.81818181818182,36.904761904761905
35005937,65,96,24,107,1,0,293,67.23549488054607,57.89473684210527
35005938,27,74,11,93,0,0,205,63.90243902439025,58.42696629213483
35005941,24,21,0,11,0,0,56,62.5,34.375
35005945,10,126,1,4,0,0,141,10.63829787234043,3.8167938931297662
35005963,36,34,0,12,0,0,82,58.53658536585367,26.086956521739136
35005969,18,50,2,7,3,0,80,37.5,19.354838709677423
35005984,114,89,14,43,2,0,262,66.03053435114504,39.86486486486487
35005985,32,44,15,18,0,0,109,59.63302752293578,42.85714285714286
35005986,6,111,1,1,0,0,119,6.72268907563025,1.7699115044247815
35006001,190,484,8,39,1,0,722,32.963988919667585,9.022556390977442
35006003,9,39,3,39,0,0,90,56.666666666666664,51.85185185185186
35006007,5,48,2,16,0,0,71,32.3943661971831,27.27272727272727
35006012,41,7,0,3,0,0,51,86.27450980392157,30.000000000000004
35006020,40,18,5,27,0,0,90,80,64
35006030,121,48,3,39,1,0,212,77.35849056603774,47.25274725274725
35006031,20,21,0,30,0,0,71,70.4225352112676,58.82352941176471
35006033,40,12,1,19,0,0,72,83.33333333333334,62.5
35006044,96,46,4,27,0,0,173,73.41040462427746,40.25974025974026
35006055,26,14,0,4,0,0,44,68.18181818181819,22.22222222222222
35006064,75,62,6,69,0,0,212,70.75471698113208,54.74452554744526
35006065,34,21,3,32,0,0,90,76.66666666666666,62.5
35006067,51,37,3,30,0,0,121,69.42148760330579,47.14285714285714
35006083,0,78,0,4,0,0,82,4.878048780487809,4.878048780487809
35006092,39,29,1,26,1,0,96,69.79166666666667,49.122807017543856
35006093,18,29,2,43,0,0,92,68.4782608695652,60.810810810810814
35006094,23,21,2,23,0,0,69,69.56521739130434,54.347826086956516
35006096,54,20,0,37,0,0,111,81.98198198198199,64.91228070175438
35006097,23,63,6,65,2,0,159,60.37735849056604,53.67647058823529
35006098,13,21,3,33,0,0,70,70,63.1578947368421
35006104,77,41,11,29,0,0,158,74.0506329113924,49.382716049382715
35006107,16,35,3,0,0,0,54,35.18518518518518,7.8947368421052655
35006111,198,255,6,47,71,1,578,55.88235294117647,32.89473684210527
35006114,2,55,1,0,0,0,58,5.1724137931034475,1.7857142857142905
35006118,29,13,1,44,4,0,91,85.71428571428572,79.03225806451613
35006120,161,41,5,56,0,1,264,84.46969696969697,60.19417475728155
35006132,135,137,21,162,6,0,461,70.28199566160521,57.97546012269939
35006136,15,50,7,51,4,1,128,60.9375,55.75221238938053
35006138,65,2,2,0,0,0,69,97.10144927536231,50
35006139,10,36,0,1,0,0,47,23.404255319148938,2.7027027027026973
35006145,57,23,3,21,0,0,104,77.88461538461539,51.06382978723405
35006147,45,18,3,13,1,0,80,77.5,48.57142857142858
35006151,34,44,6,71,0,0,155,71.61290322580645,63.63636363636363
35006158,21,124,3,0,2,0,150,17.333333333333336,3.875968992248058
35006165,92,401,2,36,1,0,532,24.624060150375936,8.863636363636363
35006167,34,10,0,26,0,0,70,85.71428571428572,72.22222222222221
35006171,100,30,2,17,1,0,150,80,40
35006204,28,42,2,16,1,0,89,52.80898876404494,31.147540983606557
35006225,20,10,4,8,0,0,42,76.19047619047619,54.54545454545454
35006228,25,56,1,50,0,2,134,58.2089552238806,48.62385321100917
35006236,24,45,5,48,1,0,123,63.41463414634146,54.54545454545454
35006239,34,56,10,57,0,0,157,64.33121019108282,54.47154471544715
35006240,76,63,7,106,2,1,255,75.29411764705883,64.80446927374301
35006241,36,77,7,75,0,0,195,60.51282051282052,51.57232704402516
35006252,0,68,0,5,5,0,78,12.82051282051282,12.82051282051282
35006268,132,108,9,243,0,1,493,78.09330628803247,70.08310249307479
35006273,98,89,1,55,0,0,243,63.37448559670782,38.62068965517241
35006284,5,43,0,7,0,0,55,21.818181818181813,14.000000000000002
35006345,248,48,5,48,0,0,349,86.24641833810888,52.475247524752476
35011807,76,262,8,67,0,2,415,36.867469879518076,22.713864306784657
35013257,41,83,8,52,1,0,185,55.13513513513513,42.361111111111114
35017048,4,32,4,12,0,0,52,38.46153846153846,33.333333333333336
35029828,135,282,37,168,2,1,625,54.879999999999995,42.44897959183673
35035580,555,204,20,229,0,1,1009,79.78196233894946,55.06607929515419
35035592,374,383,42,418,5,0,1222,68.65793780687397,54.834905660377366
35035609,199,437,44,594,2,0,1276,65.75235109717869,59.42432683379759
35035610,260,382,60,456,0,3,1161,67.09732988802757,57.60266370699223
35035622,269,425,39,300,1,0,1034,58.89748549323017,44.44444444444444
35035634,306,219,28,252,2,0,807,72.86245353159852,56.287425149700596
35035646,531,275,31,309,1,3,1150,76.08695652173914,55.5735056542811
35035658,276,148,14,182,0,0,620,76.12903225806451,56.97674418604651
35035661,517,532,64,490,0,5,1608,66.91542288557214,51.237396883593036
35036262,433,230,19,197,1,0,880,73.86363636363636,48.54586129753915
35036274,436,477,46,443,1,3,1406,66.07396870554764,50.824742268041234
35036286,456,451,63,347,5,2,1324,65.93655589123867,48.04147465437788
35036298,174,259,30,142,1,1,607,57.33113673805601,40.184757505773675
35036444,546,494,57,442,1,0,1540,67.92207792207792,50.30181086519114
35036456,240,335,40,193,0,2,810,58.64197530864197,41.22807017543859
35036500,171,137,15,103,0,0,426,67.84037558685446,46.27450980392157
35036559,72,43,16,30,1,0,162,73.45679012345678,52.222222222222214
35036560,592,257,23,305,2,2,1181,78.23878069432683,56.36672325976231
35036596,847,356,62,487,3,1,1756,79.72665148063781,60.83608360836084
35036705,501,488,63,841,4,3,1900,74.31578947368422,65.11794138670479
35036717,351,238,44,320,1,0,954,75.05241090146751,60.53067993366501
35036729,417,331,47,381,4,1,1181,71.97290431837426,56.675392670157066
35036730,611,704,97,492,4,1,1909,63.122053431115766,45.76271186440678
35036742,394,391,51,357,4,1,1198,67.36227045075125,51.3681592039801
35036754,966,436,45,216,3,4,1670,73.89221556886227,38.06818181818182
35036766,708,481,40,368,2,4,1603,69.99376169681845,46.25698324022346
35036778,562,138,17,114,1,1,833,83.43337334933973,49.07749077490775
35036785,152,154,13,133,4,0,456,66.22807017543859,49.3421052631579
35036791,356,258,27,209,0,0,850,69.64705882352942,47.773279352226716
35036808,121,81,7,57,2,0,268,69.77611940298507,44.89795918367348
35036812,181,317,38,224,3,1,764,58.50785340314136,45.626072041166374
35036821,135,370,44,235,1,0,785,52.86624203821656,43.07692307692308
35036959,609,758,76,546,1,5,1995,62.00501253132832,45.310245310245314
35036961,635,642,69,529,0,7,1882,65.88735387885228,48.516439454691266
35036973,59,288,16,127,7,1,498,42.168674698795186,34.39635535307517
35036985,93,201,9,54,1,0,358,43.85474860335196,24.15094339622641
35036997,260,156,9,87,2,2,516,69.76744186046511,39.0625
35037000,354,230,35,139,1,0,759,69.6969696969697,43.20987654320988
35037011,459,317,37,192,2,2,1009,68.58275520317146,42.36363636363636
35037023,201,463,27,353,4,0,1048,55.820610687022906,45.33648170011806
35037035,42,92,11,71,1,0,217,57.603686635944705,47.42857142857143
35037047,151,157,32,142,0,0,482,67.42738589211619,52.56797583081572
35037059,367,145,22,107,0,1,642,77.41433021806854,47.27272727272728
35037060,419,193,25,199,2,3,841,77.05112960761,54.2654028436019
35037072,638,411,44,320,11,6,1430,71.25874125874125,48.10606060606061
35037084,292,276,32,255,2,1,858,67.83216783216784,51.23674911660777
35037096,351,411,61,518,3,2,1346,69.46508172362556,58.69346733668341
35037102,109,276,53,220,0,1,659,58.11836115326252,49.81818181818182
35037333,180,138,12,46,1,0,377,63.395225464190986,29.949238578680205
35037345,279,377,26,271,1,1,955,60.52356020942409,44.230769230769226
35037357,468,500,53,505,1,0,1527,67.25605762933857,52.785646836638335
35037369,264,281,18,107,1,0,671,58.12220566318926,30.95823095823096
35037370,108,589,43,249,0,3,992,40.625,33.371040723981906
35037382,553,442,61,386,3,1,1446,69.43291839557399,50.50391937290033
35037394,248,296,18,130,1,0,693,57.287157287157285,33.483146067415724
35037400,137,331,41,365,1,0,875,62.171428571428564,55.1490514905149
35037412,401,183,26,244,1,1,856,78.6214953271028,59.78021978021978
35037424,193,344,43,229,2,2,813,57.687576875768755,44.516129032258064
35037436,378,514,70,340,8,3,1313,60.85300837776085,45.02673796791444
35037448,329,645,51,309,3,0,1337,51.75766641735229,36.011904761904766
35037459,324,508,56,275,5,1,1169,56.544054747647564,39.88165680473372
35037461,560,371,56,431,0,1,1419,73.85482734319943,56.810244470314316
35037473,444,441,53,618,4,0,1560,71.73076923076923,60.483870967741936
35037588,250,265,15,284,2,0,816,67.52450980392157,53.18021201413428
35037597,320,186,10,106,1,1,624,70.1923076923077,38.81578947368421
35037606,928,264,51,311,1,3,1558,83.05519897304237,58.09523809523809
35037618,330,275,34,277,0,2,918,70.04357298474946,53.2312925170068
35037624,514,432,64,488,5,3,1506,71.31474103585657,56.4516129032258
35037643,135,235,13,84,1,0,468,49.78632478632478,29.429429429429433
35037655,292,556,82,473,2,4,1409,60.539389638041165,50.22381378692927
35037667,275,203,7,92,0,0,577,64.81802426343155,32.78145695364238
35037679,112,412,69,286,2,1,882,53.287981859410436,46.4935064935065
35037680,420,210,19,244,0,2,895,76.53631284916202,55.78947368421052
35037692,80,195,12,87,0,1,375,48,33.89830508474576
35037709,263,398,37,256,2,5,961,58.58480749219564,42.97994269340975
35037710,43,264,15,36,2,0,360,26.66666666666667,16.719242902208197
35037722,228,360,28,165,3,0,784,54.08163265306123,35.251798561151084
35037734,10,446,63,297,8,1,825,45.93939393939394,45.27607361963191
35037746,158,168,27,101,1,0,455,63.07692307692307,43.43434343434344
35037758,191,208,12,85,3,1,500,58.400000000000006,32.68608414239482
35037761,259,192,29,127,1,0,608,68.42105263157895,44.985673352435526
35037771,242,152,5,57,0,0,456,66.66666666666667,28.971962616822434
35037783,335,520,59,319,5,7,1245,58.23293172690763,42.85714285714286
35037795,204,506,27,218,1,2,958,47.18162839248434,32.89124668435013
35037801,160,165,13,69,1,0,408,59.55882352941176,33.46774193548387
35037813,205,378,28,172,2,0,785,51.847133757961785,34.827586206896555
35038097,138,862,77,450,1,1,1529,43.623283191628516,38.03019410496046
35038106,342,242,10,60,1,1,656,63.109756097560975,22.92993630573248
35038118,645,228,28,222,2,0,1125,79.73333333333333,52.5
35038124,302,307,31,124,2,2,768,60.02604166666667,34.12017167381974
35038131,247,219,14,123,1,0,604,63.741721854304636,38.65546218487395
35038143,543,554,54,256,7,6,1420,60.98591549295775,36.830102622576966
35038155,157,278,25,135,4,0,599,53.58931552587647,37.10407239819005
35038167,148,545,35,307,8,2,1045,47.84688995215311,39.241917502787075
35038179,125,178,10,125,3,0,441,59.637188208616784,43.67088607594937
35038180,254,253,21,172,0,0,700,63.857142857142854,43.27354260089686
35038209,44,234,50,225,0,0,553,57.68535262206148,54.027504911591365
35038210,201,256,24,187,1,1,670,61.791044776119406,45.41577825159915
35038222,341,243,22,478,2,0,1086,77.62430939226519,67.38255033557047
35038234,416,494,46,445,12,0,1413,65.03892427459306,50.45135406218656
35038246,64,271,23,223,1,0,582,53.43642611683849,47.683397683397686
35038258,734,706,69,761,7,5,2282,69.06222611744084,54.39276485788114
35038261,230,185,18,129,1,2,565,67.25663716814158,44.776119402985074
35038271,259,337,25,207,3,1,832,59.495192307692314,41.186736474694584
35038283,313,176,15,272,1,4,781,77.46478873239437,62.39316239316239
35038295,320,663,76,567,4,0,1630,59.32515337423313,49.38931297709923
35038301,598,430,56,513,2,2,1601,73.1417863835103,57.128614157527416
35038313,68,147,11,133,0,0,359,59.05292479108635,49.48453608247423
35039093,233,271,14,111,0,0,629,56.91573926868044,31.565656565656564
35039100,186,240,5,52,3,0,486,50.617283950617285,19.999999999999996
35039111,153,116,2,30,0,0,301,61.46179401993355,21.62162162162162
35039123,524,750,52,683,5,2,2016,62.797619047619044,49.73190348525469
35039135,225,116,7,93,0,0,441,73.69614512471657,46.29629629629629
35039147,227,258,23,162,1,0,671,61.54992548435172,41.891891891891895
35039159,312,536,67,591,1,1,1508,64.45623342175067,55.183946488294325
35039172,90,175,26,189,2,1,483,63.76811594202898,55.470737913486005
35039214,197,274,13,239,1,1,725,62.206896551724135,48.10606060606061
35039226,230,327,12,139,1,6,715,54.26573426573427,32.577319587628864
35039238,124,249,25,170,0,0,568,56.16197183098591,43.91891891891891
35039248,610,533,28,260,1,1,1433,62.80530355896721,35.236938031591734
35039251,420,452,29,376,5,2,1284,64.797507788162,47.68518518518518
35039263,272,319,35,240,5,1,872,63.417431192660544,46.833333333333336
35039275,23,182,35,400,0,0,640,71.5625,70.50243111831442
35039287,517,662,103,616,5,2,1905,65.24934383202098,52.305475504322764
35039299,63,173,11,65,1,0,313,44.72843450479233,30.800000000000004
35039305,348,122,13,128,1,1,613,80.0978792822186,53.9622641509434
35039317,391,420,71,401,0,3,1286,67.34059097978226,53.072625698324025
35039342,116,152,6,72,1,0,347,56.195965417867434,34.19913419913419
35039354,324,379,11,135,2,0,851,55.464159811985894,28.083491461100575
35039366,238,344,38,227,2,3,852,59.624413145539904,43.97394136807817
35039378,202,359,28,160,3,2,754,52.38726790450928,34.96376811594203
35039385,224,228,22,330,0,1,805,71.67701863354037,60.75731497418244
35039391,190,158,14,161,1,11,535,70.46728971962617,54.20289855072464
35039408,53,443,17,366,1,0,880,49.65909090909091,46.4328899637243
35040319,260,325,46,234,2,1,868,62.55760368663594,46.54605263157895
35040320,518,168,25,148,1,1,861,80.48780487804879,51.02040816326531
35040332,189,216,22,159,4,0,590,63.389830508474574,46.13466334164589
35040460,144,196,42,100,0,0,482,59.33609958506224,42.01183431952663
35040472,194,226,20,137,1,1,579,60.96718480138169,41.2987012987013
35040964,416,320,30,245,1,1,1013,68.41066140177689,46.39865996649917
35040976,243,315,22,192,1,0,773,59.2496765847348,40.56603773584906
35040988,391,265,55,182,10,12,915,71.03825136612022,49.42748091603053
35040997,201,406,32,337,4,0,980,58.57142857142856,47.881899871630296
35041002,338,451,54,553,0,2,1398,67.73962804005723,57.452830188679236
35041014,216,233,19,132,1,1,602,61.29568106312293,39.637305699481864
35041026,420,410,52,428,4,7,1321,68.96290688872067,54.495005549389575
35041038,289,501,50,327,3,0,1170,57.179487179487175,43.1328036322361
35041048,350,428,42,268,4,1,1093,60.84172003659653,42.395693135935396
35041051,335,439,64,396,0,3,1237,64.51091350040421,51.330376940133036
35041063,327,632,88,577,2,5,1631,61.25076640098099,51.533742331288344
35041609,101,458,47,506,3,4,1119,59.07059874888293,55.009823182711195
35041671,225,125,13,61,0,1,425,70.58823529411764,37.5
35041683,207,169,18,137,1,1,533,68.29268292682926,48.15950920245399
35041695,423,450,34,227,1,0,1135,60.352422907488986,36.79775280898876
35041701,308,431,29,169,3,1,941,54.197662061636564,31.911532385466035
35041713,173,311,36,191,0,2,713,56.381486676016834,42.407407407407405
35041725,579,484,42,287,5,3,1400,65.42857142857143,41.04750304506699
35041737,251,327,33,354,1,6,972,66.35802469135803,54.64632454923717
35041749,105,234,27,220,1,0,587,60.13628620102215,51.45228215767634
35041750,418,383,45,320,2,1,1169,67.23695466210437,49.00133155792277
35041762,205,224,21,176,0,0,626,64.21725239616613,46.79334916864608
35041774,443,309,28,355,4,0,1139,72.87093942054435,55.603448275862064
35041786,771,381,49,395,2,0,1598,76.15769712140175,53.92986698911729
35041798,577,765,78,803,2,0,2225,65.61797752808988,53.58009708737864
35041804,698,736,94,694,6,6,2234,67.05461056401074,52.08333333333333
35043308,275,91,15,86,0,0,467,80.51391862955032,52.60416666666667
35043722,458,184,43,104,2,0,791,76.73830594184577,44.74474474474475
35043734,398,323,29,371,3,0,1124,71.26334519572954,55.509641873278234
35043746,288,443,55,224,3,3,1016,56.39763779527559,39.14835164835166
35043761,44,66,8,68,0,0,186,64.51612903225806,53.52112676056338
35043771,247,194,33,135,4,1,614,68.40390879478828,47.13896457765667
35043928,471,375,33,150,0,0,1029,63.55685131195335,32.795698924731184
35043936,140,434,32,365,6,1,978,55.623721881390594,48.21002386634845
35043941,383,111,12,178,1,0,685,83.7956204379562,63.24503311258278
35043953,517,264,44,340,2,3,1170,77.435897435897445,59.57120980091884
35044027,379,225,18,144,1,0,767,70.66492829204694,42.01030927835051
35044261,162,201,24,170,1,1,559,64.04293381037567,49.37027707808564
35044271,261,156,14,30,4,0,465,66.45161290322581,23.529411764705888
35044283,42,90,10,49,0,1,192,53.125,40
35044295,536,867,94,397,6,4,1904,54.46428571428572,36.622807017543856
35044301,296,193,19,146,0,0,654,70.48929663608563,46.089385474860336
35044313,306,266,30,262,6,2,872,69.4954128440367,53.003533568904594
35044325,643,623,87,426,3,2,1784,65.07847533632287,45.398773006134974
35044337,354,569,57,233,6,0,1219,53.322395406070555,34.21965317919076
35044349,73,127,15,112,2,1,330,61.51515151515152,50.583657587548636
35044350,164,134,17,142,3,0,460,70.86956521739131,54.72972972972974
35044362,451,205,29,227,1,0,913,77.54654983570646,55.62770562770562
35044374,216,228,31,251,2,1,729,68.72427983539094,55.55555555555556
35044386,353,293,38,352,0,1,1037,71.74541947926711,57.163742690058484
35044398,30,350,46,402,1,0,829,57.78045838359469,56.19524405506884
35044404,165,315,24,276,2,0,782,59.71867007672634,48.946515397082656
35044416,340,194,24,241,2,1,802,75.81047381546135,58.00865800865801
35044428,2,207,19,194,0,0,422,50.947867298578196,50.71428571428571
35044436,161,346,14,199,3,0,723,52.143845089903174,38.43416370106761
35044441,601,472,65,478,1,0,1617,70.81014223871367,53.54330708661416
35044453,740,504,58,592,5,5,1904,73.52941176470588,56.70103092783505
35044465,72,165,10,140,2,0,389,57.58354755784062,47.94952681388013
35046024,256,339,35,94,8,0,732,53.68852459016394,28.781512605042014
35046036,122,116,2,56,0,0,296,60.810810810810814,33.333333333333336
35046048,148,106,13,43,0,0,310,65.80645161290323,34.5679012345679
35046059,457,497,50,478,1,0,1483,66.4868509777478,51.55945419103314
35046061,225,442,47,447,0,0,1161,61.92937123169682,52.77777777777778
35046218,141,213,21,136,0,0,511,58.31702544031312,42.432432432432435
35046224,680,282,20,314,0,4,1300,78.3076923076923,54.516129032258064
35046243,371,480,63,448,7,2,1371,64.98905908096279,52
35046255,156,533,40,405,0,1,1135,53.039647577092516,45.55669050051072
35046267,162,137,8,50,0,0,357,61.62464985994398,29.743589743589748
35046279,339,423,54,214,0,3,1033,59.05130687318489,39.04899135446686
35046280,449,186,25,169,3,3,835,77.72455089820359,51.81347150259068
35046292,248,493,37,367,2,2,1149,57.09312445604874,45.28301886792453
35046309,135,210,7,93,2,0,447,53.02013422818792,32.692307692307686
35046310,384,265,29,181,1,1,861,69.22183507549362,44.44444444444444
35046334,284,217,20,206,3,0,730,70.27397260273973,51.34529147982063
35046346,540,387,48,467,3,2,1447,73.25501036627506,57.331863285556786
35046358,437,644,82,697,3,1,1864,65.45064377682404,54.87035739313244
35046361,386,358,58,404,1,2,1209,70.38875103391233,56.50060753341434
35048021,183,441,40,230,4,2,900,51,38.49372384937239
35048033,88,249,38,434,0,0,809,69.221260815822,65.46463245492372
35048598,164,280,26,113,1,1,585,52.13675213675213,33.4916864608076
35048604,376,174,31,189,3,2,775,77.54838709677419,56.390977443609025
35048616,277,528,33,285,2,1,1126,53.108348134991125,37.80918727915194
35048628,373,370,13,113,0,1,870,57.47126436781609,25.553319919517104
35048636,224,405,26,292,0,3,950,57.36842105263158,44.21487603305785
35048641,301,375,28,202,0,7,913,58.92661555312158,38.725490196078425
35048653,119,287,29,120,0,0,555,48.288288288288285,34.174311926605505
35048665,523,336,30,116,0,2,1007,66.63356504468719,30.57851239669421
35048677,614,344,56,214,3,0,1231,72.05523964256702,44.246353322528364
35048689,174,440,56,256,3,1,930,52.68817204301075,41.798941798941804
35048690,328,381,27,215,1,0,952,59.97899159663865,38.942307692307686
35048707,108,45,10,38,0,0,201,77.61194029850746,51.61290322580645
35048719,737,371,52,457,1,0,1618,77.07045735475896,57.88876276958001
35048720,308,479,52,563,4,1,1407,65.95593461265103,56.414922656960876
35048732,178,286,14,178,1,0,657,56.468797564687975,40.292275574112736
35048744,782,396,36,532,7,6,1759,77.48720864127345,59.46775844421699
35050386,356,121,12,187,3,0,679,82.17967599410898,62.538699690402474
35050398,378,214,19,294,1,1,907,76.40573318632855,59.54631379962193
35051561,114,105,12,79,3,0,313,66.45367412140575,47.23618090452262
35051573,14,63,8,80,0,24,189,66.66666666666667,64
35051585,164,204,5,105,4,14,496,58.87096774193547,38.55421686746988
35051597,167,68,6,48,1,0,290,76.55172413793103,44.71544715447154
35051603,45,63,6,28,2,0,144,56.25,36.36363636363637
35051615,39,43,6,32,0,0,120,64.16666666666666,46.913580246913575
35051627,110,68,7,57,1,0,243,72.01646090534979,48.872180451127825
35051639,130,85,9,45,3,1,273,68.86446886446886,40.55944055944056
35051640,280,82,15,57,1,5,440,81.36363636363636,48.75000000000001
35051652,125,121,7,70,8,4,335,63.880597014925364,42.38095238095239
35051664,118,75,10,39,1,5,248,69.75806451612902,42.307692307692314
35051676,161,105,24,90,4,9,393,73.2824427480916,54.741379310344826
35051688,208,80,12,92,6,5,403,80.14888337468983,58.97435897435898
35051697,143,75,3,33,2,7,263,71.48288973384031,37.5
35051706,102,193,21,87,4,4,411,53.04136253041363,37.54045307443366
35051718,135,146,17,78,1,7,384,61.97916666666667,41.36546184738956
35051724,94,81,5,23,4,1,208,61.057692307692314,28.947368421052634
35051731,93,151,11,34,4,0,293,48.4641638225256,24.5
35051743,52,199,12,65,0,2,330,39.696969696969695,28.41726618705036
35051755,65,57,3,14,1,0,140,59.285714285714285,24
35051767,93,47,3,27,1,1,172,72.67441860465115,40.50632911392405
35051779,2,76,1,43,0,0,122,37.704918032786885,36.66666666666667
35051780,0,75,6,34,0,0,115,34.78260869565217,34.78260869565217
35051792,6,61,2,42,0,1,112,45.53571428571429,42.45283018867924
35051809,84,59,7,22,2,0,174,66.0919540229885,34.44444444444444
35051810,118,105,9,77,1,0,310,66.12903225806453,45.3125
35051822,55,79,3,22,4,0,163,51.533742331288344,26.851851851851848
35051834,174,58,4,51,0,0,287,79.79094076655052,48.67256637168141
35051846,182,106,6,132,0,0,426,75.11737089201877,56.55737704918033
35051858,3,216,18,111,0,1,349,38.108882521489974,37.57225433526011
35051861,28,41,0,22,0,0,91,54.94505494505495,34.92063492063492
35051871,190,110,10,34,1,0,345,68.11594202898551,29.032258064516125
35051883,35,48,15,17,1,0,116,58.62068965517242,40.74074074074075
35051895,271,130,16,151,2,0,570,77.19298245614034,56.52173913043479
35051901,129,71,5,33,1,0,239,70.2928870292887,35.45454545454545
35051913,91,49,8,37,0,0,185,73.51351351351352,47.87234042553191
35051925,12,60,3,42,0,0,117,48.71794871794872,42.85714285714286
35051937,56,35,1,12,0,0,104,66.34615384615384,27.083333333333336
35051949,135,70,3,28,0,0,236,70.33898305084746,30.6930693069307
35051950,15,161,5,33,1,0,215,25.116279069767444,19.499999999999996
35051962,76,52,5,26,1,0,160,67.5,38.095238095238095
35051974,30,80,1,16,1,0,128,37.5,18.36734693877551
35051986,71,42,0,13,0,0,126,66.66666666666667,23.636363636363633
35051998,159,62,11,43,1,4,280,77.85714285714286,48.7603305785124
35052000,2,117,18,71,1,0,209,44.019138755980855,43.47826086956522
35052012,67,143,4,31,3,12,260,44.99999999999999,25.90673575129534
35052024,104,158,11,98,4,17,392,59.6938775510204,45.138888888888886
35052036,160,91,3,29,0,0,283,67.84452296819788,26.016260162601622
35052048,123,97,5,42,2,0,269,63.94052044609666,33.56164383561644
35052059,121,229,19,184,1,1,555,58.73873873873874,47.235023041474655
35052061,269,127,10,58,1,0,465,72.68817204301075,35.204081632653065
35052073,187,102,5,83,1,0,378,73.01587301587303,46.596858638743456
35052085,199,157,5,52,1,0,414,62.07729468599034,26.97674418604651
35052097,133,93,5,74,4,5,314,70.38216560509554,48.61878453038674
35052103,239,81,6,47,0,0,373,78.28418230563003,39.552238805970156
35052115,222,147,10,103,0,2,484,69.62809917355372,43.89312977099237
35052127,195,93,7,59,0,0,354,73.72881355932203,41.509433962264154
35052139,63,106,3,47,1,0,220,51.81818181818182,32.484076433121025
35052140,136,84,2,27,0,0,249,66.26506024096386,25.663716814159287
35052152,77,36,1,21,1,0,136,73.52941176470588,38.983050847457626
35052164,180,137,7,70,0,0,394,65.22842639593908,35.981308411214954
35052176,148,104,6,74,0,0,332,68.67469879518072,43.47826086956522
35052188,100,65,3,33,1,0,202,67.82178217821782,36.274509803921575
35052197,60,65,5,27,1,0,158,58.86075949367089,33.673469387755105
35052206,133,57,3,39,2,0,234,75.64102564102564,43.56435643564357
35052218,24,180,13,73,3,0,293,38.56655290102389,33.08550185873605
35052224,158,116,2,15,9,0,300,61.33333333333333,18.309859154929576
35052231,49,51,4,20,1,0,125,59.20000000000001,32.89473684210527
35052243,116,87,8,41,2,0,254,65.74803149606299,36.95652173913043
35052255,9,132,8,31,0,0,180,26.66666666666667,22.807017543859654
35052267,144,114,10,146,2,0,416,72.59615384615384,58.08823529411764
35052279,177,235,32,222,4,0,670,64.92537313432835,52.33265720081136
35052280,65,118,16,70,1,0,270,56.29629629629629,42.43902439024391
35052292,176,54,0,27,0,0,257,78.98832684824903,33.333333333333336
35052309,152,227,22,229,0,0,630,63.96825396825396,52.51046025104602
35052310,313,75,7,95,1,0,491,84.72505091649694,57.865168539325836
35052322,128,85,6,60,0,0,279,69.53405017921148,43.70860927152318
35052334,203,52,9,27,0,0,291,82.13058419243985,40.90909090909091
35052346,311,135,15,111,1,0,573,76.43979057591623,48.473282442748086
35052358,126,100,2,79,0,0,307,67.42671009771988,44.75138121546961
35052361,182,104,5,53,1,0,345,69.85507246376812,36.19631901840491
35052371,69,141,5,61,3,1,280,49.642857142857146,33.175355450236964
35052383,39,34,3,18,1,0,95,64.21052631578948,39.28571428571429
35052395,73,123,3,24,1,1,225,45.333333333333336,19.07894736842105
35052401,26,92,9,38,0,1,166,44.57831325301205,34.285714285714285
35052413,61,44,5,33,0,5,148,70.27027027027026,49.42528735632183
35052425,1,78,5,31,1,13,129,39.53488372093024,39.0625
35052437,57,32,3,21,1,2,116,72.41379310344827,45.76271186440678
35052449,189,93,5,34,0,0,321,71.02803738317758,29.54545454545454
35052450,7,70,1,11,3,0,92,23.913043478260864,17.647058823529417
35052462,183,229,9,64,2,0,487,52.977412731006154,24.67105263157895
35052474,59,111,4,18,3,0,195,43.07692307692308,18.38235294117647
35052486,104,84,0,16,1,0,205,59.024390243902445,16.831683168316836
35052498,200,207,14,154,3,4,582,64.43298969072164,45.81151832460733
35052504,130,83,5,20,10,0,248,66.53225806451613,29.66101694915254
35052516,213,212,10,67,1,0,503,57.85288270377733,26.89655172413793
35052528,202,233,7,93,12,5,552,57.789855072463766,33.42857142857143
35052536,185,89,6,39,4,0,323,72.44582043343652,35.507246376811594
35052541,19,200,12,147,1,0,379,47.229551451187334,44.44444444444444
35052553,12,51,3,41,1,0,108,52.77777777777778,46.875
35052565,174,99,5,69,0,1,348,71.55172413793103,43.103448275862064
35052577,55,36,5,11,0,0,107,66.35514018691589,30.76923076923077
35052589,35,126,6,196,1,2,366,65.57377049180329,61.93353474320242
35052590,104,248,1,143,1,0,497,50.100603621730386,36.895674300254456
35052607,46,66,7,43,1,2,165,60,44.53781512605042
35052619,103,126,7,70,4,7,317,60.252365930599375,41.12149532710281
35052620,155,165,11,166,2,5,504,67.26190476190477,52.72206303724929
35052632,84,179,5,72,6,0,346,48.26589595375722,31.6793893129771
35052644,48,63,6,26,0,1,144,56.25,34.375
35052656,228,108,9,104,0,0,449,75.94654788418708,51.13122171945701
35052668,168,112,9,55,1,0,345,67.53623188405797,36.7231638418079
35052673,146,70,1,24,0,0,241,70.95435684647302,26.315789473684216
35052681,100,155,12,53,1,0,321,51.71339563862929,29.864253393665162
35052693,90,100,11,36,0,0,237,57.80590717299579,31.97278911564626
35052711,58,171,5,75,0,0,309,44.66019417475729,31.872509960159366
35052723,105,113,5,30,1,3,257,56.03112840466926,25.657894736842103
35052735,164,122,14,76,0,0,376,67.5531914893617,42.45283018867924
35052747,137,59,8,31,0,1,236,75,40.40404040404041
35052759,255,123,13,113,2,1,507,75.7396449704142,51.19047619047619
35052760,259,54,0,51,0,0,364,85.16483516483517,48.57142857142858
35052772,232,69,12,76,2,0,391,82.35294117647058,56.60377358490566
35052784,90,78,10,282,0,0,460,83.04347826086956,78.9189189189189
35052796,285,78,7,163,1,0,534,85.39325842696628,68.67469879518072
35052802,161,257,14,98,0,1,531,51.600753295668554,30.54054054054054
35052814,100,146,5,51,1,0,303,51.81518151815181,28.078817733990146
35052826,24,185,13,120,0,1,343,46.06413994169096,42.006269592476485
35052838,3,114,12,40,1,0,170,32.94117647058824,31.73652694610778
35052848,81,103,9,58,1,2,254,59.4488188976378,40.46242774566474
35052851,112,103,11,85,0,0,311,66.88102893890675,48.24120603015075
35052863,10,226,13,192,0,0,441,48.752834467120174,47.56380510440835
35052875,366,145,3,85,0,0,599,75.79298831385643,37.768240343347635
35052887,161,155,8,72,1,1,398,61.05527638190955,34.59915611814346
35052899,203,88,5,34,0,1,331,73.41389728096676,31.25
35052905,130,184,21,122,0,1,458,59.82532751091703,43.90243902439024
35052917,212,142,10,230,1,1,596,76.1744966442953,63.02083333333333
35052929,115,181,16,183,3,0,498,63.654618473895574,52.74151436031331
35052930,443,130,9,101,4,0,687,81.07714701601164,46.721311475409834
35052942,189,90,3,121,0,0,403,77.66749379652606,57.94392523364487
35052954,186,88,6,68,0,0,348,74.71264367816092,45.67901234567901
35052966,90,153,12,134,6,1,396,61.36363636363637,50
35052978,27,173,7,210,1,0,418,58.61244019138756,55.754475703324815
35052985,240,83,8,83,0,0,414,79.95169082125604,52.29885057471264
35052991,147,109,6,44,0,0,306,64.37908496732025,31.44654088050315
35053004,190,67,6,105,2,0,370,81.89189189189189,62.77777777777778
35053016,348,323,17,183,4,1,876,63.12785388127854,38.82575757575758
35053028,55,217,11,65,1,0,349,37.82234957020057,26.190476190476186
35053036,71,331,7,104,1,1,515,35.728155339805824,25.450450450450447
35053041,422,416,76,289,3,7,1213,65.70486397361913,47.408343868520866
35053053,240,634,71,511,16,0,1472,56.92934782608696,48.538961038961034
35053065,225,497,66,362,8,5,1163,57.265692175408425,47.01492537313433
35053077,74,393,71,338,1,1,878,55.23917995444192,51.11940298507462
35053089,141,695,101,610,0,0,1547,55.07433742727861,50.56899004267426
35053090,199,413,42,297,10,0,961,57.02393340270552,45.800524934383205
35053107,370,326,49,304,0,0,1049,68.92278360343185,51.988217967599404
35053119,142,534,91,426,2,0,1195,55.31380753138075,49.287749287749286
35053120,177,550,60,258,6,1,1052,47.71863117870723,37.142857142857146
35053132,277,274,55,299,4,2,911,69.92316136114161,56.782334384858046
35053144,250,383,28,103,12,1,777,50.70785070785071,27.324478178368118
35053156,149,453,79,295,5,1,982,53.86965376782078,45.61824729891957
35053168,438,369,32,334,4,4,1181,68.75529212531752,50.33647375504711
35053173,267,523,61,331,4,2,1188,55.97643097643097,43.21389793702497
35053181,257,217,33,240,0,5,752,71.1436170212766,56.161616161616166
35053193,171,484,45,305,4,5,1014,52.26824457593688,42.586002372479236
35053200,343,276,64,276,4,0,963,71.33956386292834,55.483870967741936
35053211,20,570,77,661,2,0,1330,57.14285714285714,56.48854961832062
35053223,505,398,22,119,6,0,1050,62.095238095238095,26.97247706422018
35053235,238,622,43,246,5,0,1154,46.10051993067591,32.096069868995635
35053247,341,397,47,321,6,1,1113,64.33063791554358,48.57512953367875
35053259,393,385,50,297,2,2,1129,65.89902568644818,47.690217391304344
35053260,335,282,46,230,0,0,893,68.42105263157895,49.46236559139785
35053272,395,341,27,277,1,0,1041,67.24303554274735,47.21362229102167
35053284,52,274,28,198,1,0,553,50.45207956600362,45.309381237524946
35053296,537,442,52,300,14,10,1355,67.380073800738,45.965770171149146
35053302,371,350,127,196,3,5,1052,66.73003802281369,48.604992657856094
35053314,318,744,46,293,2,0,1403,46.97077690662865,31.428571428571427
35053326,299,276,18,146,3,1,743,62.85329744279946,37.83783783783784
35053348,180,641,135,471,26,5,1458,56.035665294924556,49.84350547730829
35053351,447,557,97,341,4,9,1455,61.718213058419245,44.74206349206349
35053363,190,408,134,443,2,41,1218,66.50246305418719,60.31128404669261
35053375,177,416,35,243,7,8,886,53.04740406320542,41.32581100141044
35053387,173,399,36,270,4,1,883,54.81313703284258,43.80281690140845
35053399,111,208,32,179,0,1,531,60.8286252354049,50.476190476190474
35053405,151,375,153,431,1,10,1121,66.54772524531668,61.34020618556701
35053417,182,207,31,181,0,2,603,65.67164179104478,50.83135391923991
35053429,75,278,30,189,1,1,574,51.56794425087108,44.28857715430862
35053430,375,395,23,279,0,0,1072,63.15298507462687,43.32855093256814
35053442,329,408,28,237,3,1,1006,59.44333996023856,39.73412112259971
35053454,143,260,37,374,1,1,816,68.13725490196079,61.36701337295691
35053466,166,426,62,404,3,0,1061,59.849198868991515,52.402234636871505
35053478,451,413,46,275,3,1,1189,65.26492851135409,44.03794037940379
35053485,392,230,31,280,2,0,935,75.40106951871658,57.6427255985267
35053491,101,459,53,416,0,0,1029,55.39358600583091,50.53879310344828
35053508,252,495,65,315,6,1,1134,56.34920634920635,43.87755102040817
35053512,68,306,31,205,4,1,615,50.24390243902439,44.05850091407678
35053521,353,234,13,174,8,3,785,70.19108280254778,45.833333333333336
35053533,71,376,26,311,0,1,785,52.101910828025474,47.33893557422969
35053545,415,303,87,267,3,2,1077,71.86629526462396,54.229607250755286
35053557,140,378,124,457,5,0,1104,65.76086956521738,60.78838174273859
35053569,230,399,16,166,44,12,867,53.979238754325266,37.362637362637365
35053570,173,335,33,167,2,0,710,52.816901408450704,37.61638733705773
35053582,228,416,43,307,9,6,1009,58.77106045589693,46.73495518565941
35053594,226,422,52,376,1,6,1083,61.03416435826408,50.758459743290544
35053600,172,306,53,126,5,1,663,53.84615384615385,37.67820773930753
35053612,230,444,47,200,1,2,924,51.94805194805194,36.023054755043226
35053624,375,146,19,171,5,3,719,79.69401947148818,57.55813953488372
35053636,679,315,43,155,5,1,1198,73.70617696160267,39.30635838150289
35053648,343,306,59,176,1,0,885,65.42372881355932,43.542435424354245
35053659,154,343,28,176,4,0,705,51.34751773049646,37.74954627949183
35053661,647,542,58,316,3,1,1567,65.41161455009572,41.086956521739125
35053673,76,546,37,278,1,1,939,41.853035143769965,36.73232908458864
35053685,267,1005,66,636,11,7,1992,49.548192771084345,41.73913043478261
35053697,366,381,20,145,0,0,912,58.223684210526315,30.219780219780223
35053703,173,380,35,162,2,2,754,49.602122015915114,34.595524956970735
35053715,381,691,49,289,3,2,1415,51.1660777385159,33.172147001934235
35053727,141,493,24,266,0,3,927,46.817691477885646,37.27735368956743
35053739,45,368,53,173,5,0,644,42.85714285714286,38.56427378964942
35053740,192,494,57,207,9,2,961,48.5952133194589,35.760728218465545
35053752,125,760,76,334,2,1,1298,41.44838212634823,35.208866155157715
35053764,19,341,44,227,5,0,636,46.38364779874213,44.73257698541329
35053776,609,336,42,304,0,2,1293,74.0139211136891,50.877192982456144
35053788,521,476,49,314,5,0,1365,65.12820512820512,43.60189573459715
35053797,4,393,36,765,0,4,1202,67.30449251247921,67.19532554257096
35053806,262,390,35,214,0,2,903,56.81063122923589,39.1575663026521
35053818,31,576,41,396,2,1,1047,44.985673352435526,43.30708661417323
35053824,120,750,79,669,6,0,1624,53.81773399014777,50.13297872340425
35053831,256,461,42,440,4,0,1203,61.67913549459685,51.31995776135163
35053843,196,337,24,218,2,2,779,56.73940949935815,42.19554030874786
35053855,561,491,62,463,3,1,1581,68.943706514864,51.86274509803921
35053867,55,388,11,135,5,0,594,34.68013468013468,28.014842300556587
35053879,371,370,39,384,4,0,1168,68.32191780821918,53.5759096612296
35053880,378,430,51,539,4,0,1402,69.32952924393723,58.0078125
35053892,243,443,27,252,6,1,972,54.42386831275721,39.2318244170096
35053909,14,669,57,408,1,0,1149,41.77545691906005,41.05726872246696
35053910,110,754,59,314,3,4,1244,39.38906752411575,33.50970017636684
35053922,39,511,70,590,8,1,1219,58.08039376538146,56.69491525423729
35053934,524,240,35,253,2,1,1055,77.25118483412322,54.80225988700565
35053946,485,323,75,412,1,2,1298,75.115562403698,60.27060270602706
35053958,493,561,80,950,5,5,2094,73.20916905444126,64.95940037476578
35053961,341,340,66,433,4,2,1186,71.33220910623945,59.76331360946745
35053971,40,724,107,986,4,5,1866,61.20042872454447,60.35049288061336
35053983,145,552,39,383,2,0,1121,50.758251561106164,43.442622950819676
35053995,375,241,40,173,9,17,855,71.81286549707602,49.791666666666664
35054008,298,529,31,207,4,0,1069,50.51449953227316,31.387808041504538
35054012,84,545,87,650,0,0,1366,60.102489019033676,57.488299531981276
35054021,302,577,54,435,10,2,1380,58.18840579710145,46.47495361781077
35054033,318,360,31,277,4,0,990,63.63636363636363,46.42857142857143
35054045,305,504,66,475,5,1,1356,62.83185840707964,52.04567078972408
35054057,716,320,35,292,2,0,1365,76.55677655677655,50.69337442218797
35054069,341,369,81,492,0,2,1285,71.284046692607,60.91101694915254
35054070,577,238,38,319,0,2,1174,79.7274275979557,60.13400335008375
35054082,304,368,37,251,4,2,966,61.904761904761905,44.41087613293051
35054094,26,374,45,1143,0,4,1592,76.50753768844221,76.11749680715198
35054100,402,324,52,480,1,6,1265,74.38735177865613,62.45654692931634
35054112,509,465,38,475,0,0,1487,68.728984532616,52.45398773006136
35054124,20,650,65,462,1,0,1198,45.742904841402336,44.821731748726656
35054136,118,599,33,234,3,3,990,39.494949494949495,31.30733944954128
35054148,277,473,24,221,5,0,1000,52.7,34.57814661134163
35054159,90,425,29,248,0,0,792,46.338383838383834,39.458689458689456
35054161,259,460,75,393,2,0,1189,61.312026913372584,50.53763440860215
35054173,93,495,34,274,8,1,905,45.30386740331491,39.039408866995075
35054185,296,550,26,199,3,3,1077,48.9322191272052,29.5774647887324
35054197,439,537,36,364,4,3,1383,61.17136659436009,43.11440677966102
35054203,77,644,33,219,5,0,978,34.15132924335378,28.52386237513873
35054215,696,365,71,445,3,5,1585,76.97160883280758,58.94263217097863
35054227,62,438,49,488,2,1,1040,57.88461538461538,55.21472392638036
35054239,394,543,73,434,3,2,1449,62.525879917184255,48.530805687203795
35054240,422,380,15,250,0,0,1067,64.38612933458295,41.08527131782945
35054252,314,307,21,325,4,2,973,68.448098663926,53.41426403641882
35054264,505,504,89,493,0,1,1592,68.34170854271358,53.63385464581416
35054276,130,495,59,520,6,2,1212,59.158415841584166,54.25138632162662
35054288,83,446,73,385,3,0,990,54.94949494949495,50.82690187431091
35054297,228,363,17,213,1,3,825,56.00000000000001,39.19597989949749
35054306,27,426,23,184,0,0,660,35.45454545454545,32.70142180094787
35054318,353,490,28,363,6,0,1240,60.483870967741936,44.7576099210823
35054324,635,471,50,594,1,1,1752,73.11643835616438,57.833482542524614
35054331,256,558,50,474,1,3,1342,58.42026825633383,48.61878453038674
35054343,526,679,56,583,1,7,1852,63.33693304535637,48.79336349924586
35054355,27,244,45,306,27,16,665,63.308270676691734,61.75548589341693
35054367,75,360,44,122,1,0,602,40.199335548172755,31.688804554079695
35054379,151,653,26,200,3,1,1034,36.84719535783365,26.047565118912797
35054380,243,408,23,136,2,2,814,49.877149877149876,28.546409807355523
35054392,145,248,20,100,4,1,518,52.12355212355213,33.51206434316354
35054409,353,356,16,73,3,0,801,55.55555555555556,20.535714285714292
35054410,75,636,42,417,4,24,1198,46.91151919866444,43.365983971504896
35054422,144,717,69,390,3,3,1326,45.92760180995475,39.340101522842644
35054434,88,564,40,502,13,14,1221,53.8083538083538,50.22065313327448
35054446,94,264,14,133,0,0,505,47.72277227722772,35.76642335766424
35054458,185,489,43,261,2,5,985,50.35532994923858,38.87500000000001
35054461,99,387,69,375,1,1,932,58.47639484978541,53.54141656662665
35054471,273,373,23,200,1,1,871,57.175660160734786,37.625418060200666
35054483,360,580,41,339,7,5,1332,56.45645645645645,40.32921810699589
35054495,232,646,96,655,1,0,1630,60.36809815950921,53.79113018597997
35054501,145,509,51,239,3,4,951,46.47739221871714,36.848635235732004
35054513,59,344,23,168,9,0,603,42.951907131011616,36.76470588235294
35054525,276,663,52,281,11,0,1283,48.324240062353866,34.160873882820255
35054537,406,472,59,323,9,6,1275,62.98039215686275,45.68469505178366
35054549,118,526,33,231,1,0,909,42.13421342134214,33.50189633375474
35054550,415,413,24,158,7,4,1021,59.54946131243879,31.84818481848185
35054562,310,648,25,262,5,4,1254,48.325358851674636,31.355932203389834
35054574,203,370,20,149,2,1,745,50.33557046979866,31.734317343173434
35054586,307,509,23,103,3,1,946,46.19450317124736,20.344287949921757
35054598,34,659,55,162,9,0,919,28.291621327529924,25.536723163841813
35054604,78,159,10,131,5,0,383,58.485639686684074,47.868852459016395
35054616,130,560,8,314,0,1,1013,44.71865745310958,36.57984144960362
35054628,190,399,39,245,6,1,880,54.659090909090914,42.173913043478265
35054636,174,403,38,165,1,2,783,48.53128991060025,33.82594417077176
35054641,303,405,44,244,2,0,998,59.4188376753507,41.72661870503597
35054653,551,547,33,420,1,3,1555,64.82315112540194,45.517928286852595
35054665,253,526,22,164,4,3,972,45.88477366255144,26.84283727399166
35054677,279,472,31,147,0,3,932,49.35622317596567,27.718223583460954
35054690,462,424,20,300,1,2,1209,64.92969396195203,43.239625167336015
35054707,168,225,16,103,2,0,514,56.22568093385214,34.97109826589595
35054719,154,532,27,375,2,2,1092,51.28205128205128,43.28358208955224
35054720,84,519,25,751,1,2,1382,62.44573082489146,60.015408320493066
35054732,190,754,56,507,8,3,1518,50.329380764163375,43.22289156626506
35054744,277,296,23,177,2,11,786,62.34096692111959,41.846758349705304
35054756,264,543,25,371,5,5,1213,55.23495465787305,42.781875658587985
35054768,138,275,17,166,5,21,622,55.78778135048231,43.18181818181818
35054773,215,242,26,158,3,0,644,62.422360248447205,43.58974358974359
35054781,231,227,49,109,5,0,621,63.44605475040257,41.79487179487179
35054793,434,290,36,140,3,2,905,67.95580110497237,38.42887473460722
35054800,229,381,37,137,10,3,797,52.19573400250941,32.9225352112676
35054811,83,483,39,198,10,6,819,41.02564102564102,34.375
35054823,200,450,62,195,5,0,912,50.6578947368421,36.79775280898876
35054835,320,405,71,191,5,6,998,59.4188376753507,40.26548672566371
35054847,223,275,56,135,3,2,694,60.37463976945246,41.6135881104034
35054859,410,535,47,250,4,0,1246,57.062600321027276,36.004784688995215
35054860,490,253,14,159,5,0,921,72.52985884907709,41.29930394431555
35054872,137,407,51,256,2,0,853,52.28604923798359,43.15642458100558
35054884,155,433,42,291,0,0,921,52.985884907709014,43.472584856396864
35054896,354,543,83,440,11,9,1440,62.291666666666664,50
35054902,77,520,71,409,0,19,1096,52.55474452554745,48.969578017664375
35054914,611,761,48,411,0,0,1831,58.438012015292195,37.62295081967213
35054926,358,207,18,173,0,0,756,72.61904761904762,47.98994974874372
35054938,45,807,42,242,7,0,1143,29.396325459317584,26.502732240437155
35054948,260,131,4,106,3,0,504,74.0079365079365,46.31147540983606
35054951,15,70,0,22,0,0,107,34.57943925233645,23.913043478260864
35054963,215,396,13,145,9,0,778,49.100257069408734,29.662522202486674
35054975,72,367,23,245,4,0,711,48.38255977496484,42.56651017214398
35054987,239,593,30,286,14,4,1166,49.14236706689537,36.03020496224379
35054999,146,500,33,229,0,0,908,44.93392070484582,34.38320209973753
35055001,166,460,11,207,6,0,850,45.88235294117647,32.748538011695906
35055013,174,703,42,397,1,1,1318,46.661608497723826,38.548951048951054
35055025,67,307,17,146,2,0,539,43.04267161410018,34.95762711864406
35055037,118,857,58,347,5,5,1390,38.3453237410072,32.62578616352201
35055049,161,667,27,208,3,1,1067,37.48828491096532,26.379690949227374
35055050,56,569,8,210,3,7,853,33.29425556858148,28.607277289836887
35055062,17,425,60,132,15,1,650,34.61538461538461,32.859399684044234
35055074,138,485,51,331,2,0,1007,51.837140019860975,44.18872266973533
35055086,53,792,35,248,5,0,1133,30.097087378640776,26.66666666666667
35055098,210,340,22,136,1,2,711,52.18002812939522,32.13572854291418
35055104,115,286,18,80,5,0,504,43.25396825396825,26.478149100257063
35055116,293,315,21,202,3,1,835,62.27544910179641,41.88191881918819
35055128,205,617,39,154,3,6,1024,39.74609375,24.664224664224665
35055136,316,467,100,361,7,1,1252,62.69968051118211,50.10683760683761
35055141,295,533,114,256,2,10,1210,55.950413223140494,41.748633879781416
35055153,265,334,28,231,4,1,863,61.297798377752024,44.147157190635454
35055165,444,221,16,116,1,1,799,72.34042553191489,37.74647887323944
35055177,229,257,42,231,4,1,764,66.36125654450262,51.96261682242991
35055189,494,749,88,502,3,2,1838,59.24918389553863,44.270833333333336
35055190,94,574,58,407,6,0,1139,49.60491659350307,45.07177033492823
35055207,455,506,52,341,6,1,1361,62.82145481263777,44.15011037527594
35055219,420,473,50,530,4,5,1482,68.08367071524965,55.46139359698682
35055220,486,609,51,468,0,0,1614,62.26765799256506,46.01063829787234
35055232,727,367,26,342,2,0,1464,74.93169398907105,50.20352781546811
35055244,250,330,24,139,0,1,744,55.64516129032258,33.198380566801625
35055256,287,515,48,344,0,0,1194,56.867671691792296,43.219404630650494
35055268,571,296,45,262,1,1,1176,74.82993197278911,51.074380165289256
35055273,577,561,19,273,1,2,1433,60.851360781577114,34.4626168224299
35055281,110,231,21,223,0,1,586,60.580204778157,51.470588235294116
35055293,111,787,34,431,1,0,1364,42.30205278592375,37.190742218675176
35055300,97,463,61,474,6,0,1101,57.94732061762035,53.884462151394416
35055311,196,247,38,580,6,1,1068,76.87265917602997,71.67431192660551
35055323,176,513,44,306,3,0,1042,50.76775431861804,40.762124711316396
35055335,226,813,106,551,0,0,1696,52.06367924528301,44.693877551020414
35055347,442,570,50,193,12,0,1267,55.01183898973954,30.909090909090907
35055359,463,615,61,372,0,5,1516,59.43271767810027,41.5954415954416
35055360,321,662,36,196,12,0,1227,46.04726976365118,26.931567328918327
35055372,624,623,48,328,3,1,1627,61.70866625691457,37.88634097706879
35055384,353,351,38,265,4,3,1014,65.38461538461539,46.89863842662633
35055396,329,510,45,240,4,1,1129,54.827280779450845,36.25000000000001
35055402,217,568,54,387,1,2,1229,53.78356387306753,43.873517786561266
35055414,775,440,94,427,0,0,1736,74.65437788018433,54.21436004162331
35055426,143,546,63,378,0,2,1132,51.76678445229682,44.79271991911021
35055438,506,444,20,219,2,2,1193,62.78290025146689,35.37117903930132
35055448,608,397,28,286,1,2,1322,69.9697428139183,44.397759103641455
35055451,267,405,15,142,1,1,831,51.26353790613718,28.191489361702125
35055463,51,517,53,415,2,0,1038,50.19267822736031,47.61904761904761
35055475,87,556,42,456,3,0,1144,51.39860139860139,47.398297067171235
35055487,236,471,24,260,0,3,994,52.61569416498995,37.86279683377308
35055499,101,669,43,333,0,2,1148,41.724738675958186,36.10315186246418
35055505,264,501,35,319,4,1,1124,55.427046263345204,41.744186046511636
35055517,264,443,43,273,1,1,1025,56.78048780487806,41.78712220762155
35055529,172,387,69,458,0,2,1088,64.43014705882352,57.751091703056765
35055530,122,951,109,505,1,4,1692,43.794326241134755,39.42675159235669
35055542,368,423,46,365,3,0,1205,64.89626556016597,49.46236559139785
35055554,375,718,70,541,1,2,1707,57.937902753368476,46.0960960960961
35055566,389,450,30,189,5,0,1063,57.66698024459078,33.23442136498517
35055578,405,389,22,255,0,0,1071,63.67880485527544,41.591591591591595
35055585,235,510,67,676,2,2,1492,65.8176943699732,59.427207637231504
35055591,240,495,46,320,4,0,1105,55.203619909502265,42.77456647398844
35055608,58,738,42,479,3,3,1323,44.21768707482994,41.660079051383406
35055612,401,438,58,548,2,2,1449,69.77225672877847,58.206106870229
35055621,204,394,29,233,1,2,863,54.34530706836617,40.21244309559939
35055633,879,515,52,493,3,1,1943,73.4945959855893,51.597744360902254
35055645,182,686,50,529,3,0,1450,52.689655172413794,45.89905362776025
35055657,521,399,58,507,1,1,1487,73.16745124411567,58.69565217391304
35055669,377,464,35,166,4,5,1051,55.851569933396775,31.15727002967359
35055670,305,395,22,355,0,0,1077,63.32404828226556,48.83419689119171
35055682,366,453,53,460,5,0,1337,66.11817501869858,53.3470648815654
35055694,699,630,59,372,6,3,1769,64.38665912945167,41.12149532710281
35055700,123,752,47,582,5,3,1512,50.264550264550266,45.86033117350612
35055712,79,571,52,467,2,6,1177,51.48683092608326,47.99635701275046
35055724,446,731,53,540,1,2,1773,58.77044557247603,44.913338357196686
35055736,426,452,37,445,5,0,1365,66.88644688644689,51.863684771033014
35055748,381,412,31,271,4,1,1100,62.54545454545455,42.698191933240615
35055759,597,401,47,212,4,0,1261,68.19984139571768,39.608433734939766
35056571,410,313,58,291,7,0,1079,70.99165894346618,53.21375186846039
35056583,376,104,17,116,1,0,614,83.06188925081433,56.30252100840336
35056704,192,74,4,53,1,0,324,77.1604938271605,43.939393939393945
35056716,396,496,43,189,0,4,1128,56.02836879432624,32.240437158469945
35056881,52,129,1,64,0,0,246,47.5609756097561,33.50515463917526
35056972,99,87,9,47,0,0,242,64.0495867768595,39.16083916083915
35056996,346,163,24,116,2,1,652,75,46.73202614379085
35057022,233,108,9,50,1,0,401,73.06733167082294,35.71428571428571
35057034,183,23,5,21,0,0,232,90.08620689655173,53.06122448979591
35057125,222,355,22,161,0,0,760,53.289473684210535,34.01486988847584
35057289,114,76,7,31,0,0,228,66.66666666666667,33.333333333333336
35057332,324,446,58,482,2,1,1313,66.03198781416604,54.903943377148636
35057484,236,82,11,66,0,0,395,79.24050632911393,48.42767295597484
35057548,125,83,10,85,0,0,303,72.60726072607261,53.37078651685394
35057551,382,416,41,473,3,3,1318,68.43702579666162,55.55555555555556
35057575,335,116,17,115,1,0,584,80.13698630136986,53.41365461847389
35057605,109,63,12,47,0,1,232,72.84482758620689,48.78048780487805
35057666,230,548,22,286,1,2,1089,49.678604224058766,36.20488940628638
35057691,151,71,1,14,1,0,238,70.16806722689076,18.39080459770115
35057733,217,150,27,283,0,1,678,77.87610619469027,67.46203904555314
35057812,99,65,3,82,0,1,250,74,56.95364238410596
35057836,184,219,19,138,0,2,562,61.032028469750884,42.063492063492056
35057873,118,90,3,39,0,0,250,64,31.818181818181824
35057903,318,125,17,154,0,0,614,79.64169381107492,57.77027027027026
35057915,131,45,1,51,2,0,230,80.43478260869566,54.54545454545454
35058002,409,453,46,271,2,1,1182,61.6751269035533,41.39715394566623
35058051,304,130,15,82,4,1,536,75.74626865671642,43.96551724137932
35058063,83,120,11,103,0,1,318,62.264150943396224,48.93617021276596
35058075,225,386,28,300,1,1,941,58.97980871413391,46.089385474860336
35058087,53,99,13,68,0,0,233,57.510729613733915,44.99999999999999
35058117,186,49,5,37,0,0,277,82.31046931407943,46.15384615384615
35058129,186,56,2,35,0,0,279,79.92831541218638,39.784946236559136
35058166,279,119,12,107,2,1,520,77.11538461538461,50.62240663900415
35058178,167,66,4,63,1,1,302,78.1456953642384,51.11111111111111
35058185,230,534,46,476,4,7,1297,58.82806476484195,49.95313964386129
35058191,175,151,14,154,0,0,494,69.43319838056681,52.66457680250783
35058208,156,48,53,26,1,1,285,83.15789473684211,62.7906976744186
35058212,521,421,43,440,4,1,1430,70.55944055944056,53.68536853685369
35058257,52,264,26,271,4,3,620,57.41935483870968,53.52112676056338
35058440,133,44,3,46,0,0,226,80.53097345132744,52.68817204301075
35058452,163,383,78,605,2,4,1235,68.98785425101215,64.27238805970148
35058464,242,119,14,319,0,0,694,82.85302593659942,73.67256637168141
35058488,97,87,9,119,2,1,315,72.38095238095238,60.09174311926606
35058518,224,141,17,136,3,0,521,72.93666026871402,52.52525252525253
35058865,36,9,2,14,3,0,64,85.9375,67.85714285714286
35058920,1,29,1,45,0,0,76,61.8421052631579,61.33333333333333
35059079,73,43,3,32,0,0,151,71.52317880794702,44.87179487179487
35059080,83,13,1,11,1,0,109,88.07339449541286,50
35059183,63,30,6,40,0,1,140,78.57142857142857,61.038961038961034
35059596,67,57,2,11,0,0,137,58.3941605839416,18.571428571428573
35059808,39,26,2,30,1,2,100,74,57.377049180327866
35059973,89,13,0,9,0,0,111,88.28828828828829,40.90909090909091
35059985,14,35,2,26,0,0,77,54.54545454545454,44.44444444444444
35060331,175,592,59,386,5,0,1217,51.35579293344289,43.186180422264876
35060549,211,308,11,265,3,0,798,61.40350877192983,47.5298126064736
35060550,100,132,6,69,0,1,308,57.14285714285714,36.53846153846154
35060562,330,479,56,607,2,2,1476,67.54742547425474,58.20244328097731
35060574,88,396,3,10,5,0,502,21.11553784860558,4.347826086956519
35060586,139,252,23,257,3,0,674,62.61127596439169,52.89719626168225
35060847,124,39,2,57,0,1,223,82.51121076233183,60.60606060606061
35060948,346,111,14,68,1,0,540,79.44444444444446,42.78350515463918
35060963,231,19,7,47,1,0,305,93.77049180327869,74.32432432432432
35061141,61,41,2,20,0,1,125,67.19999999999999,35.9375
35061992,67,21,1,13,2,0,104,79.8076923076923,43.24324324324324
35062029,39,25,0,42,0,0,106,76.41509433962264,62.68656716417911
35062777,145,214,20,174,1,0,554,61.37184115523466,47.67726161369193
35062789,272,394,43,247,1,0,957,58.82967607105538,42.481751824817515
35062790,44,348,78,649,0,0,1119,68.90080428954424,67.62790697674419
35062807,141,754,46,451,0,2,1394,45.91104734576758,39.8244213886672
35063058,13,54,4,24,0,0,95,43.15789473684211,34.14634146341463
35063071,85,151,1,12,2,0,251,39.8406374501992,9.036144578313255
35063332,112,313,13,30,3,0,471,33.54564755838641,12.8133704735376
35066266,489,413,35,315,2,2,1256,67.11783439490446,46.15384615384615
35066278,61,34,1,19,2,0,117,70.94017094017093,39.28571428571429
35066285,7,103,21,137,0,0,268,61.56716417910448,60.53639846743295
35066291,337,106,8,173,1,1,626,83.06709265175719,63.32179930795847
35066308,894,304,47,422,12,5,1684,81.94774346793349,61.518987341772146
35066312,128,108,20,126,6,0,388,72.16494845360825,58.46153846153845
35066734,227,271,24,142,0,1,665,59.248120300751886,38.12785388127854
35068627,192,477,56,309,5,24,1063,55.12699905926623,45.2353616532721
35068639,149,164,6,96,0,0,415,60.48192771084337,38.34586466165414
35068640,114,108,6,43,3,1,275,60.72727272727273,32.919254658385086
35068652,40,133,12,95,0,0,280,52.5,44.58333333333333
35068664,234,636,71,387,11,4,1343,52.6433358153388,42.65103697024346
35068676,314,378,39,383,1,0,1115,66.09865470852017,52.80898876404494
35068688,173,126,40,221,2,2,564,77.65957446808511,67.77493606138107
35068697,233,397,48,258,3,0,939,57.7209797657082,43.76770538243626
35068706,136,369,42,323,1,1,872,57.68348623853211,49.8641304347826
35068718,487,544,69,592,3,0,1695,67.90560471976401,54.96688741721854
35068724,148,87,7,96,0,0,338,74.2603550295858,54.21052631578947
35068731,68,571,120,593,0,2,1354,57.828655834564245,55.59875583203733
35068743,278,339,43,343,4,0,1007,66.3356504468719,53.497942386831276
35068755,133,107,12,68,0,0,320,66.5625,42.78074866310161
35068767,548,571,55,407,3,3,1587,64.02016383112792,45.04331087584216
35068779,358,578,69,631,1,4,1641,64.77757464960389,54.94933749025721
35068780,97,629,57,399,3,0,1185,46.91983122362869,42.1875
35068792,428,295,44,348,0,0,1115,73.54260089686099,57.059679767103354
35068809,349,399,45,341,0,0,1134,64.81481481481481,49.17197452229299
35068810,368,315,53,313,1,2,1052,70.05703422053232,53.94736842105263
35068822,378,410,35,322,6,6,1157,64.56352636127917,47.36842105263158
35068834,53,497,53,647,4,0,1254,60.366826156299844,58.61781848459617
35070178,265,624,146,433,5,7,1480,57.83783783783784,48.641975308641975
35070185,573,318,16,261,1,1,1170,72.82051282051283,46.733668341708544
35070191,173,349,36,321,1,2,882,60.430839002267575,50.77574047954866
35070208,312,365,29,209,2,3,920,60.32608695652174,39.9671052631579
35071936,82,654,5,21,3,0,765,14.509803921568631,4.245973645680823
35072230,457,479,46,430,4,1,1417,66.19618913196894,50.10416666666666
35072285,163,47,8,70,0,0,288,83.68055555555556,62.4
35072357,5,82,0,4,1,0,92,10.869565217391308,5.747126436781613
35072473,35,19,1,17,0,0,72,73.61111111111111,48.64864864864865
35072497,10,24,5,14,3,0,56,57.14285714285714,47.82608695652174
35072503,93,320,60,223,0,3,699,54.220314735336196,47.1947194719472
35072552,452,426,69,337,8,3,1295,67.10424710424711,49.4661921708185
35074640,295,90,7,81,2,0,475,81.05263157894737,50
35074652,130,250,14,168,0,0,562,55.51601423487544,42.129629629629626
35074664,84,106,9,113,2,1,315,66.34920634920634,54.112554112554115
35074676,230,194,20,152,1,1,598,67.55852842809364,47.28260869565217
35074688,326,205,10,85,1,0,627,67.30462519936205,31.893687707641195
35074697,168,113,7,45,4,0,337,66.46884272997033,33.13609467455622
35074706,173,160,7,45,1,2,388,58.76288659793815,25.581395348837212
35074718,213,47,9,29,1,0,299,84.2809364548495,45.34883720930233
35074724,35,105,19,161,0,0,320,67.1875,63.1578947368421
35074731,549,353,59,299,0,0,1260,71.98412698412699,50.35161744022503
35074743,892,461,98,536,4,2,1993,76.86904164576016,58.1289736603088
35074755,230,127,13,185,2,0,557,77.19928186714542,61.16207951070336
35074767,234,665,125,826,3,0,1853,64.11225040474906,58.92526250772081
35075395,334,107,15,138,0,0,594,81.98653198653199,58.84615384615385
35075553,464,98,19,118,0,1,700,86,58.47457627118644
35075565,3,195,17,204,0,0,419,53.46062052505967,53.125
35075577,206,109,18,84,1,0,418,73.92344497607655,48.58490566037735
35075589,177,164,31,237,0,0,609,73.07060755336617,62.03703703703704
35076119,55,96,7,140,0,1,299,67.89297658862876,60.65573770491803
35076120,29,140,30,211,1,0,411,65.93673965936739,63.35078534031413
35076132,352,348,22,292,3,13,1030,66.2135922330097,48.67256637168141
35076144,239,265,21,270,4,2,801,66.91635455680401,52.84697508896797
35076156,80,54,1,11,0,1,147,63.26530612244898,19.402985074626866
35076168,163,42,8,44,0,1,258,83.72093023255813,55.78947368421052
35076173,151,35,17,71,1,0,275,87.27272727272728,71.7741935483871
35076181,436,314,71,397,5,0,1223,74.32542927228127,60.10165184243965
35076193,138,101,10,113,0,0,362,72.09944751381215,54.91071428571428
35076200,301,102,6,194,2,0,605,83.14049586776859,66.44736842105263
35078759,233,246,20,156,0,0,655,62.44274809160305,41.70616113744076
35078761,251,146,12,124,0,0,533,72.6078799249531,48.22695035460993
35078773,509,468,44,406,2,0,1429,67.24982505248424,49.1304347826087
35078785,55,472,50,674,2,0,1253,62.33040702314445,60.60100166944908
35078797,371,464,27,479,2,0,1343,65.45048399106477,52.2633744855967
35079005,41,71,8,63,2,0,185,61.621621621621614,50.69444444444444
35079017,30,63,13,50,1,0,157,59.87261146496815,50.39370078740157
35079029,1,19,8,16,1,0,45,57.77777777777777,56.81818181818181
35079030,12,53,16,93,1,0,175,69.71428571428571,67.48466257668711
35079042,32,48,6,40,0,0,126,61.904761904761905,48.93617021276596
35079736,2,42,6,22,0,0,72,41.666666666666664,40
35079881,270,156,7,127,0,0,560,72.14285714285714,46.20689655172414
35080998,283,74,6,43,0,0,406,81.77339901477832,39.83739837398373
35081000,218,167,12,150,1,1,549,69.58105646630237,49.546827794561935
35081012,28,242,30,276,0,3,579,58.20379965457685,56.07985480943738
35081024,283,126,3,66,0,0,478,73.64016736401673,35.38461538461538
35082314,99,167,24,154,1,0,445,62.47191011235955,51.73410404624277
35082326,94,102,3,28,0,0,227,55.06607929515419,23.308270676691734
35082466,14,17,6,28,1,0,66,74.24242424242425,67.3076923076923
35082521,122,99,14,41,3,0,279,64.51612903225806,36.94267515923567
35083948,486,515,52,447,4,0,1504,65.75797872340425,49.41060903732809
35083951,50,13,0,4,0,0,67,80.59701492537313,23.529411764705888
35083963,113,561,36,377,1,0,1088,48.4375,42.46153846153846
35083975,139,118,14,141,1,0,413,71.42857142857143,56.934306569343065
35083987,48,172,12,164,2,0,398,56.78391959798995,50.857142857142854
35084177,123,70,4,35,1,1,234,70.08547008547008,36.93693693693694
35084220,91,255,29,137,1,1,514,50.38910505836576,39.71631205673759
35084232,5,227,7,155,0,1,395,42.53164556962026,41.79487179487179
35084244,200,81,7,51,5,3,347,76.657060518732,44.89795918367348
35084256,122,87,6,45,0,0,260,66.53846153846155,36.95652173913043
35084268,84,229,23,80,0,0,416,44.95192307692307,31.024096385542165
35084273,188,46,6,27,0,0,267,82.77153558052434,41.77215189873418
35084281,80,107,8,32,7,0,234,54.27350427350428,30.519480519480524
35084293,50,190,3,64,0,0,307,38.11074918566775,26.070038910505833
35084300,265,174,23,129,2,0,593,70.65767284991568,46.95121951219512
35084311,97,40,4,23,1,0,165,75.75757575757575,41.17647058823529
35084323,233,125,5,44,1,1,409,69.43765281173594,28.97727272727273
35084335,363,98,6,73,2,0,542,81.91881918819189,45.2513966480447
35084347,34,58,2,27,2,0,123,52.84552845528455,34.8314606741573
35084359,17,101,11,91,0,0,220,54.090909090909086,50.24630541871922
35084360,109,33,2,27,1,0,172,80.81395348837209,47.61904761904761
35084372,105,111,5,67,1,0,289,61.5916955017301,39.67391304347826
35084384,131,90,4,50,1,0,276,67.3913043478261,37.93103448275862
35084396,294,161,15,68,3,0,541,70.24029574861368,34.81781376518218
35084402,196,145,24,172,2,1,540,73.14814814814814,57.84883720930232
35085479,157,98,4,60,1,0,320,69.375,39.877300613496935
35085480,179,50,2,42,0,0,273,81.68498168498168,46.808510638297875
35085492,133,145,13,113,0,1,405,64.19753086419753,46.69117647058824
35085509,4,179,12,120,0,1,316,43.35443037974683,42.62820512820513
35085510,56,44,3,9,0,0,112,60.71428571428572,21.42857142857143
35085522,193,205,2,60,2,0,462,55.62770562770562,23.79182156133829
35085534,41,201,10,121,1,0,374,46.256684491978604,39.63963963963963
35085546,204,144,4,54,2,0,408,64.70588235294117,29.411764705882348
35085558,120,558,73,601,2,1,1355,58.81918819188192,54.81781376518219
35085561,111,116,10,205,1,1,444,73.87387387387388,65.16516516516518
35085571,87,89,2,39,0,0,217,58.986175115207374,31.538461538461537
35085583,127,66,3,99,0,0,295,77.62711864406779,60.71428571428572
35085595,135,74,10,138,1,0,358,79.32960893854748,66.81614349775784
35085601,19,234,19,245,2,0,519,54.91329479768786,53.2
35087105,274,182,14,76,1,0,547,66.72760511882998,33.333333333333336
35087117,209,102,7,94,1,0,413,75.30266343825666,50
35087129,183,104,10,91,0,0,388,73.1958762886598,49.26829268292683
35087130,121,168,10,77,0,0,376,55.319148936170215,34.11764705882353
35087142,177,483,42,465,0,0,1167,58.61182519280206,51.21212121212122
35087154,84,547,64,658,0,0,1353,59.57132298595713,56.89519306540583
35087166,171,83,9,78,0,0,341,75.65982404692082,51.17647058823529
35087178,168,176,18,146,1,1,510,65.49019607843137,48.538011695906434
35087185,122,56,6,35,0,0,219,74.42922374429224,42.26804123711341
35087191,296,738,23,352,0,0,1409,47.62242725337118,33.692722371967655
35087208,83,92,11,69,0,0,255,63.921568627450974,46.51162790697675
35087212,154,53,10,32,1,1,251,78.88446215139442,45.36082474226804
35087221,70,59,2,16,0,0,147,59.863945578231295,23.376623376623375
35087233,90,81,8,54,0,0,233,65.23605150214593,43.35664335664335
35087245,108,107,6,38,0,0,259,58.687258687258684,29.139072847682122
35087257,38,87,19,53,2,0,199,56.28140703517588,45.962732919254655
35087269,199,53,10,41,0,0,303,82.50825082508251,49.03846153846154
35087270,17,133,21,94,4,1,270,50.74074074074074,47.430830039525695
35087282,318,326,34,343,1,1,1023,68.13294232649072,53.758865248226954
35087294,195,51,10,57,2,0,315,83.80952380952381,57.49999999999999
35087300,108,79,7,52,0,0,246,67.88617886178862,42.7536231884058
35087580,27,126,7,158,1,0,319,60.501567398119114,56.849315068493155
35087592,192,66,9,53,0,0,320,79.375,48.4375
35087609,139,113,5,72,1,0,330,65.75757575757576,40.83769633507853
35087610,16,105,1,19,3,1,145,27.586206896551722,18.6046511627907
35087622,262,129,8,56,0,0,455,71.64835164835165,33.16062176165803
35087634,138,44,11,66,1,0,260,83.07692307692307,63.934426229508205
35087646,92,121,11,97,0,0,321,62.30529595015577,47.161572052401745
35087658,156,134,22,234,0,1,547,75.50274223034735,65.72890025575447
35087661,191,518,40,537,0,4,1290,59.84496124031008,52.86624203821656
35087671,85,32,6,39,0,0,162,80.24691358024691,58.44155844155844
35090585,403,513,89,557,6,0,1568,67.28316326530613,55.96566523605151
35090591,405,382,57,379,3,2,1228,68.89250814332247,53.58444714459295
35090608,363,98,14,109,0,1,585,83.24786324786325,55.855855855855864
35090612,70,562,75,292,2,3,1004,44.02390438247012,39.82869379014989
35090621,102,212,44,155,1,0,514,58.754863813229576,48.54368932038835
35090633,169,49,1,34,0,0,253,80.63241106719367,41.666666666666664
35090645,105,50,6,27,1,0,189,73.54497354497354,40.476190476190474
35090657,84,81,16,78,0,0,259,68.72586872586872,53.714285714285715
35090669,157,90,6,46,0,0,299,69.89966555183946,36.61971830985915
35090670,102,82,18,47,1,0,250,67.19999999999999,44.5945945945946
35090682,110,164,10,158,6,0,448,63.39285714285714,51.4792899408284
35090694,174,89,1,100,4,1,369,75.88075880758808,54.358974358974365
35090700,61,87,13,85,0,2,248,64.91935483870968,53.475935828877
35090712,39,230,26,156,0,2,453,49.22737306843267,44.44444444444444
35090724,121,179,21,81,2,0,404,55.693069306930695,36.74911660777384
35090736,129,68,7,58,0,0,262,74.04580152671755,48.872180451127825
35091340,328,416,29,214,3,3,993,58.106747230614296,37.44360902255639
35091352,194,578,54,304,1,0,1131,48.894783377542,38.313767342582715
35091364,188,74,5,21,0,0,288,74.30555555555556,26
35091376,49,77,20,56,1,0,203,62.06896551724138,50
35091388,238,69,14,65,0,1,387,82.17054263565892,53.691275167785236
35091397,128,149,16,77,0,0,370,59.72972972972973,38.42975206611571
35091406,546,419,71,301,4,0,1341,68.75466070096942,47.29559748427673
35091418,568,383,67,312,9,3,1342,71.46050670640834,50.51679586563307
35091424,376,850,120,572,4,1,1923,55.79823192927718,45.05494505494505
35091431,180,51,11,83,2,3,330,84.54545454545455,65.99999999999999
35091443,117,139,10,99,1,0,366,62.02185792349727,44.17670682730924
35092575,103,1552,70,684,14,5,2428,36.07907742998353,33.24731182795699
35092587,144,84,7,74,1,0,310,72.90322580645162,49.397590361445786
35092599,148,76,11,83,2,0,320,76.25,55.81395348837209
35092605,142,124,10,71,0,0,347,64.26512968299711,39.51219512195122
35092617,154,184,10,135,2,0,485,62.06185567010309,44.41087613293051
35092629,257,88,3,60,0,0,408,78.43137254901961,41.72185430463576
35092630,48,142,38,147,8,8,391,63.68286445012787,58.60058309037901
35092642,307,136,10,90,0,2,545,75.04587155963303,42.85714285714286
35092654,143,68,4,120,1,1,337,79.82195845697329,64.94845360824742
35092666,142,124,6,112,1,2,387,67.95865633074936,49.38775510204082
35092678,73,99,10,59,0,0,241,58.921161825726145,41.07142857142857
35092685,216,59,6,87,0,0,368,83.96739130434783,61.184210526315795
35092691,40,109,11,45,1,0,206,47.0873786407767,34.337349397590366
35092708,224,57,8,54,0,0,343,83.38192419825073,52.100840336134446
35092712,167,55,10,57,0,0,289,80.96885813148789,54.91803278688525
35092721,188,51,5,47,0,0,291,82.4742268041237,50.48543689320388
35092733,193,69,10,108,0,0,380,81.84210526315789,63.10160427807487
35092745,490,300,30,665,0,0,1485,79.7979797979798,69.84924623115577
35092757,120,105,19,87,1,2,334,68.562874251497007,50.93457943925234
35092769,178,65,8,45,4,2,302,78.47682119205298,47.58064516129033
35092770,167,75,11,114,1,0,368,79.61956521739131,62.68656716417911
35092782,176,66,6,37,0,0,285,76.84210526315789,39.449541284403665
35092794,108,211,18,139,0,0,476,55.67226890756303,42.66304347826087
35092800,195,48,10,38,1,0,292,83.56164383561644,50.51546391752577
35092812,63,125,10,114,0,0,312,59.93589743589743,49.79919678714859
35092824,90,138,13,172,1,0,414,66.66666666666667,57.407407407407405
35092836,347,107,13,108,0,0,575,81.3913043478261,53.07017543859649
35092848,127,105,1,60,1,0,294,64.28571428571428,37.125748502994014
35092859,168,65,13,111,4,0,361,81.994459833795,66.32124352331607
35092861,3,121,15,347,1,0,487,75.15400410677618,75
35092873,92,131,10,70,0,0,303,56.76567656765676,37.91469194312796
35092885,208,91,6,61,0,0,366,75.13661202185793,42.40506329113924
35092897,137,103,8,146,1,0,395,73.92405063291139,60.07751937984496
35092903,69,103,14,158,0,0,344,70.05813953488372,62.54545454545455
35092915,104,96,21,130,0,0,351,72.64957264957265,61.1336032388664
35092927,141,64,4,35,1,1,246,73.98373983739836,39.047619047619044
35092939,136,133,3,43,0,0,315,57.77777777777777,25.698324022346362
35092940,161,145,6,80,1,1,394,63.1979695431472,37.768240343347635
35092952,147,181,49,188,2,1,568,68.13380281690141,57.00712589073634
35092964,85,120,40,153,0,0,398,69.84924623115577,61.66134185303515
35092976,676,281,60,306,1,4,1328,78.84036144578313,56.90184049079754
35094766,51,78,6,38,1,1,175,55.42857142857143,37.096774193548384
35094778,25,151,13,151,0,0,340,55.58823529411765,52.063492063492056
35094785,472,437,40,437,3,1,1390,68.56115107913669,52.39651416122004
35094791,203,41,7,93,0,0,344,88.0813953488372,70.92198581560284
35094924,136,80,15,59,0,0,290,72.41379310344827,48.05194805194806
35095291,6,133,6,300,0,0,445,70.11235955056179,69.70387243735763
35095539,162,117,9,57,0,0,345,66.08695652173913,36.065573770491795
35095540,11,89,7,65,1,0,173,48.554913294797686,45.06172839506173
35095552,105,148,14,179,1,1,448,66.96428571428572,56.85131195335277
35095564,28,152,17,78,2,0,277,45.12635379061371,38.955823293172685
35095576,6,252,12,103,6,30,409,38.38630806845966,37.468982630272954
35095588,133,213,10,101,7,0,464,54.0948275862069,35.649546827794566
35095597,191,152,14,97,2,0,456,66.66666666666667,42.64150943396226
35095606,642,675,60,624,7,3,2011,66.43460964694182,50.69393718042367
35095618,189,93,9,54,2,0,347,73.19884726224784,41.13924050632911
35095624,83,93,6,74,0,0,256,63.671875,46.24277456647399
35095631,68,516,41,376,0,0,1001,48.451548451548454,44.69453376205787
35095643,84,42,4,68,0,0,198,78.78787878787878,63.1578947368421
35095655,132,157,13,79,0,1,382,58.90052356020943,37.2
35095667,177,46,6,39,1,1,270,82.96296296296296,50.53763440860215
35095679,221,134,12,101,4,2,474,71.72995780590718,47.03557312252964
35095680,41,108,11,93,1,1,255,57.647058823529406,49.532710280373834
35095692,1,165,29,224,0,0,419,60.620525059665866,60.526315789473685
35095709,145,616,26,271,1,0,1059,41.83191690273843,32.603938730853386
35095710,69,108,22,87,0,0,286,62.23776223776224,50.23041474654377
35095722,233,172,15,153,0,0,573,69.9825479930192,49.411764705882355
35095734,79,155,14,145,2,0,395,60.75949367088608,50.9493670886076
35095746,149,90,7,70,2,0,318,71.69811320754718,46.74556213017751
35095758,50,80,8,104,0,0,242,66.94214876033058,58.33333333333333
35095761,174,73,7,69,0,2,325,77.53846153846153,51.65562913907284
35095771,247,61,4,111,0,1,424,85.61320754716981,65.5367231638418
35098358,50,390,32,132,0,0,604,35.43046357615894,29.602888086642597
35098361,228,60,11,102,2,1,404,85.14851485148515,65.90909090909092
35098371,311,832,42,572,2,4,1763,52.80771412365286,42.69972451790633
35098383,16,271,14,266,1,0,568,52.2887323943662,50.90579710144927
35098395,139,72,1,119,1,3,335,78.50746268656717,63.26530612244898
35098401,210,395,96,401,0,0,1102,64.15607985480945,55.71748878923767
35098413,82,108,12,87,3,1,293,63.139931740614344,48.81516587677726
35098425,230,76,7,35,3,0,351,78.34757834757835,37.1900826446281
35098437,68,85,8,97,0,0,258,67.05426356589147,55.263157894736835
35098449,105,47,4,61,0,0,217,78.34101382488478,58.03571428571428
35098450,364,96,10,73,8,0,551,82.57713248638838,48.66310160427807
35098462,238,242,21,163,0,1,665,63.60902255639098,43.325526932084315
35098474,210,238,30,241,1,2,722,67.03601108033241,53.515625
35098486,20,383,50,347,3,0,803,52.3038605230386,51.08556832694764
35098498,632,214,23,207,2,2,1080,80.18518518518518,52.23214285714286
35098504,54,90,9,80,1,0,234,61.53846153846154,50
35098516,39,68,6,56,0,0,169,59.76331360946745,47.692307692307686
35098528,389,401,47,500,2,2,1341,70.09694258016405,57.8781512605042
35098536,20,427,15,276,1,0,739,42.2192151556157,40.61196105702365
35098541,181,240,34,346,1,0,802,70.07481296758104,61.352657004830924
35098553,50,277,20,112,0,1,460,39.78260869565218,32.4390243902439
35098565,213,172,17,165,1,1,569,69.77152899824253,51.685393258426956
35098577,17,768,69,703,4,2,1563,50.8637236084453,50.323415265200524
35098589,100,515,56,412,3,0,1086,52.57826887661141,47.76876267748479
35098590,11,554,68,466,1,0,1100,49.63636363636363,49.127640036730945
35098607,120,356,26,207,2,0,711,49.92967651195499,39.763113367174284
35098619,142,212,30,246,2,1,633,66.5086887835703,56.82281059063137
35098620,154,120,8,133,0,0,415,71.08433734939759,54.02298850574713
35098632,146,483,40,569,1,3,1242,61.111111111111114,55.93065693430657
35098644,49,500,67,462,2,2,1082,53.78927911275415,51.5972894482091
35098656,141,81,7,102,0,0,331,75.52870090634441,57.36842105263158
35098668,43,352,40,204,6,1,646,45.5108359133127,41.625207296849084
35098673,30,138,21,83,1,1,274,49.63503649635036,43.442622950819676
35098681,3,266,6,36,0,0,311,14.469453376205788,13.636363636363635
35098693,98,154,12,44,1,0,309,50.16181229773462,27.014218009478675
35098700,139,247,33,266,0,2,687,64.04657933042213,54.92700729927007
35098711,276,70,17,73,5,1,442,84.16289592760181,57.831325301204814
35098723,150,506,53,263,4,0,976,48.15573770491803,38.74092009685231
35098735,390,358,27,292,5,0,1072,66.60447761194031,47.50733137829912
35098747,7,140,8,53,0,0,208,32.692307692307686,30.348258706467657
35098759,402,117,8,74,1,1,603,80.59701492537313,41.7910447761194
35098760,354,330,10,216,3,0,913,63.85542168674698,40.9660107334526
35098772,208,299,23,254,1,0,785,61.910828025477706,48.18024263431543
35098784,270,297,37,437,3,0,1044,71.55172413793103,61.627906976744185
35100024,81,418,0,11,0,6,516,18.992248062015506,3.9080459770114984
35100031,22,498,2,19,4,0,545,8.62385321100917,4.780114722753348
35100043,84,586,2,11,0,0,683,14.202049780380676,2.170283806343909
35100080,74,181,19,58,1,1,334,45.808383233532936,30.384615384615387
35100092,37,55,9,19,0,0,120,54.16666666666667,33.734939759036145
35100134,63,42,1,2,4,0,112,62.5,14.28571428571429
35100161,80,150,11,27,0,0,268,44.029850746268664,20.21276595744681
35100171,93,250,4,6,1,0,354,29.378531073446325,4.214559386973182
35100183,120,171,18,66,3,0,378,54.761904761904766,33.720930232558146
35100213,66,339,12,23,4,0,444,23.648648648648653,10.317460317460315
35100250,19,62,5,10,0,0,96,35.416666666666664,19.480519480519476
35100298,30,291,4,12,3,1,341,14.662756598240467,6.430868167202575
35100304,65,555,6,24,1,0,651,14.746543778801847,5.290102389078499
35100328,39,121,2,3,0,1,166,27.108433734939762,4.7244094488189
35100353,147,465,25,134,5,3,779,40.30808729139923,26.42405063291139
35100365,87,219,14,61,1,0,382,42.67015706806283,25.762711864406786
35100420,196,846,3,2,6,0,1053,19.658119658119656,1.2835472578763163
35100432,58,2137,7,23,37,0,2262,5.526083112290003,3.0399274047186897
35100444,98,234,9,29,2,1,373,37.26541554959786,14.909090909090905
35100456,46,251,3,5,4,0,309,18.77022653721683,4.562737642585546
35100473,467,1837,9,51,20,0,2384,22.944630872483216,4.173187271778822
35100493,38,164,1,9,3,1,216,24.07407407407407,7.86516853932584
35100547,190,584,11,50,14,0,849,31.21319199057715,11.380880121396054
35100572,32,60,1,5,0,0,98,38.775510204081634,9.090909090909093
35100663,102,504,3,19,3,0,631,20.12678288431062,4.725897920604916
35100730,506,538,18,66,2,2,1132,52.473498233215544,14.057507987220452
35100785,49,393,0,7,2,0,451,12.860310421286037,2.238805970149249
35100808,719,1032,31,219,18,5,2024,49.011857707509876,20.919540229885058
35100833,56,369,3,12,9,0,449,17.817371937639205,6.106870229007633
35100900,130,179,3,14,1,2,329,45.59270516717325,10.050251256281406
35100912,166,740,14,35,13,1,969,23.632610939112485,7.845579078455788
35100959,48,3,0,1,0,0,52,94.23076923076923,25
35100985,19,180,0,8,1,0,208,13.461538461538458,4.761904761904767
35101011,198,458,13,52,4,3,728,37.08791208791209,13.584905660377355
35101047,97,478,6,24,4,1,610,21.63934426229508,6.822612085769986
35101084,30,157,0,8,1,0,196,19.897959183673475,5.421686746987953
35101096,132,130,6,11,3,0,282,53.90070921985816,13.33333333333333
35101148,54,201,0,6,1,0,262,23.282442748091604,3.3653846153846145
35101151,114,441,7,7,4,0,573,23.03664921465969,3.9215686274509776
35101175,112,960,3,14,44,0,1133,15.269196822594877,5.974534769833495
35101242,41,10,0,0,0,0,51,80.3921568627451,0
35101266,200,441,29,88,2,0,760,41.973684210526315,21.250000000000004
35101278,473,2236,5,18,41,1,2774,19.394376351838506,2.824858757062143
35101333,87,377,4,16,50,1,535,29.53271028037383,15.84821428571429
35101369,6,66,1,16,0,0,89,25.842696629213478,20.481927710843372
35101448,135,600,3,36,52,2,828,27.536231884057973,13.41991341991342
35101459,18,103,1,8,0,0,130,20.769230769230774,8.03571428571429
35101503,30,167,0,4,5,0,206,18.93203883495146,5.113636363636365
35101539,27,242,4,4,2,0,279,13.261648745519716,3.9682539682539653
35101564,122,328,0,36,11,1,498,34.13654618473896,12.765957446808507
35101597,79,1188,8,30,4,1,1310,9.31297709923664,3.4930950446791176
35101618,166,357,8,20,2,0,553,35.44303797468354,7.751937984496127
35101643,67,597,0,26,13,1,704,15.198863636363635,6.279434850863419
35101667,43,303,13,15,12,0,386,21.502590673575128,11.661807580174932
35101679,115,685,10,23,4,0,837,18.16009557945042,5.124653739612183
35101692,68,678,4,15,10,0,775,12.51612903225806,4.101838755304099
35101710,30,330,1,15,10,0,386,14.507772020725385,7.303370786516849
35101722,177,460,0,14,4,0,655,29.77099236641222,3.765690376569042
35101734,184,770,11,31,26,0,1022,24.65753424657534,8.114558472553702
35101761,26,80,2,21,0,1,130,38.46153846153846,23.076923076923073
35101771,158,234,8,36,2,0,438,46.57534246575342,16.428571428571427
35101795,78,154,6,12,14,0,264,41.666666666666664,17.204301075268813
35101813,78,275,1,7,7,0,368,25.271739130434778,5.1724137931034475
35101837,34,23,2,9,0,0,68,66.17647058823529,32.35294117647059
35101850,531,322,2,9,8,0,872,63.07339449541285,5.571847507331373
35101862,80,27,7,36,2,0,152,82.23684210526316,62.5
35101886,159,722,2,21,14,0,918,21.350762527233115,4.87483530961792
35101898,266,260,2,3,5,0,536,51.49253731343284,3.703703703703709
35101904,562,344,5,10,9,0,930,63.01075268817205,6.521739130434778
35101916,57,264,5,1,1,0,328,19.512195121951216,2.583025830258301
35101941,186,980,17,9,16,0,1208,18.87417218543046,4.109589041095896
35101965,517,681,14,42,11,1,1266,46.20853080568721,9.078771695594124
35101989,53,558,9,29,12,0,661,15.582450832072613,8.223684210526317
35101990,44,301,2,22,3,0,372,19.08602150537635,8.231707317073166
35102015,275,305,5,25,5,0,615,50.40650406504066,10.29411764705882
35102027,18,40,2,3,0,0,63,36.50793650793651,11.111111111111116
35102039,306,765,15,66,12,1,1165,34.33476394849786,10.942956926658908
35102040,522,421,13,55,2,0,1013,58.440276406712734,14.256619144602855
35102076,205,932,7,54,9,0,1207,22.783761391880695,6.986027944111772
35102088,381,696,17,83,7,3,1187,41.3647851727043,13.64764267990074
35102124,72,389,8,10,1,0,480,18.958333333333332,4.656862745098033
35102155,138,159,10,35,0,0,342,53.50877192982456,22.058823529411764
35102167,222,267,7,81,1,0,578,53.80622837370241,25
35102180,111,147,7,51,0,0,316,53.48101265822785,28.292682926829272
35102210,125,30,5,47,1,0,208,85.57692307692308,63.85542168674698
35102258,309,290,21,82,0,0,702,58.6894586894587,26.20865139949109
35102283,129,191,5,33,2,0,360,46.94444444444444,17.31601731601732
35102295,298,262,20,95,4,0,679,61.413843888070694,31.233595800524938
35102301,118,188,4,48,4,1,363,48.209366391184574,23.26530612244898
35102313,23,107,5,73,1,0,209,48.803827751196174,42.47311827956989
35102350,77,203,4,22,84,4,394,48.47715736040609,35.96214511041009
35102416,341,78,4,84,2,6,515,84.85436893203884,55.172413793103445
35102428,396,689,24,121,6,1,1237,44.30072756669361,18.073721759809747
35102465,100,247,4,32,5,1,389,36.50385604113111,14.53287197231834
35102489,8,38,1,4,0,0,51,25.49019607843137,11.627906976744185
35102490,72,488,3,10,12,0,585,16.58119658119658,4.873294346978563
35102635,234,210,2,14,4,0,464,54.741379310344826,8.695652173913048
35102659,86,62,1,8,3,0,160,61.25000000000001,16.216216216216218
35102660,200,390,1,3,3,1,598,34.78260869565217,2.010050251256279
35102714,4,43,0,4,3,0,54,20.370370370370374,14.000000000000002
35102751,276,657,14,33,32,0,1012,35.079051383399204,10.733695652173914
35102787,91,505,2,7,9,0,614,17.75244299674267,3.441682600382412
35102799,258,1374,16,28,9,1,1686,18.50533807829181,3.7815126050420145
35102805,334,619,7,19,13,0,992,37.6008064516129,5.927051671732519
35102829,112,715,9,28,6,0,870,17.816091954022983,5.672823218997358
35102842,3,65,0,0,0,0,68,4.411764705882348,0
35102854,60,199,3,6,2,0,270,26.296296296296294,5.238095238095242
35102885,73,84,8,19,4,1,189,55.55555555555556,27.586206896551722
35102891,116,28,1,34,0,0,179,84.35754189944133,55.55555555555556
35102970,2,129,0,9,0,0,140,7.857142857142863,6.521739130434778
35102982,57,136,8,18,0,2,221,38.46153846153846,17.07317073170732
35103044,143,94,11,92,0,0,340,72.35294117647058,52.28426395939086
35103100,2,0,0,0,0,63,65,100,100
35103123,90,456,2,7,15,0,570,19.999999999999996,5.000000000000004
35103147,63,54,0,9,0,0,126,57.14285714285714,14.28571428571429
35103248,190,365,6,30,9,1,601,39.267886855241265,11.192214111922139
35103263,210,228,27,90,15,1,571,60.070052539404564,36.8421052631579
35103275,20,177,15,50,4,0,266,33.45864661654135,28.04878048780488
35103329,19,64,11,36,3,0,133,51.8796992481203,43.85964912280702
35103342,429,474,7,29,23,0,962,50.72765072765073,11.06941838649156
35103408,35,58,0,5,2,0,100,42.00000000000001,10.769230769230765
35103421,123,333,2,22,29,0,509,34.577603143418465,13.730569948186533
35103433,246,710,11,47,107,1,1122,36.72014260249554,18.94977168949772
35103445,284,282,4,12,1,0,583,51.6295025728988,5.685618729096986
35103494,218,167,2,14,7,0,408,59.068627450980394,12.105263157894742
35103500,11,69,1,3,0,0,84,17.85714285714286,5.47945205479452
35103512,163,67,1,6,0,0,237,71.72995780590718,9.459459459459463
35103524,594,3912,10,49,101,0,4666,16.15945135019289,3.9292730844793677
35103536,26,435,2,0,0,0,463,6.0475161987041055,0.4576659038901587
35103548,681,1160,4,22,18,0,1885,38.46153846153846,3.6544850498338888
35103561,24,204,6,37,3,0,274,25.547445255474454,18.400000000000006
35103615,1,41,0,0,0,0,42,2.3809523809523836,0
35103697,486,223,0,4,2,1,716,68.85474860335195,3.04347826086957
35103718,253,838,5,12,37,0,1145,26.812227074235807,6.053811659192821
35103767,72,31,3,15,1,0,122,74.59016393442623,38
35103780,53,640,0,1,2,0,696,8.045977011494255,0.4665629860031051
35103792,14,83,0,0,2,0,99,16.161616161616166,2.352941176470591
35103834,78,176,2,6,0,0,262,32.82442748091603,4.347826086956519
35103861,1057,1389,25,104,53,2,2630,47.18631178707224,11.697393515575339
35103925,2,88,0,0,0,0,90,2.2222222222222254,0
35104012,11,108,0,0,0,0,119,9.243697478991598,0
35104097,131,201,0,8,0,0,340,40.88235294117647,3.8277511961722466
35104206,90,269,2,11,4,0,376,28.457446808510632,5.944055944055949
35104218,37,96,2,11,4,0,150,36,15.04424778761062
35104334,154,190,0,1,1,0,346,45.08670520231214,1.041666666666663
35104358,71,33,0,2,0,0,106,68.86792452830188,5.714285714285716
35104449,65,800,9,8,6,0,888,9.909909909909908,2.7946537059538312
35104450,103,313,1,2,0,0,419,25.298329355608594,0.9493670886076
35104589,9,149,10,38,5,0,211,29.383886255924175,26.237623762376238
35104590,133,402,1,15,16,0,567,29.100529100529105,7.3732718894009235
35104607,142,583,1,1,1,0,728,19.917582417582413,0.5119453924914641
35104619,89,95,2,33,1,0,220,56.81818181818181,27.480916030534353
35104620,689,2243,33,128,17,2,3112,27.92416452442159,7.428807263722659
35104644,109,220,4,11,6,0,350,37.142857142857146,8.713692946058094
35104668,1,103,0,0,0,0,104,0.9615384615384581,0
35104673,25,148,4,7,2,0,186,20.430107526881724,8.074534161490687
35104711,78,668,0,3,0,0,749,10.814419225634175,0.44709388971684305
35104875,219,799,7,45,5,1,1076,25.743494423791823,6.76779463243874
35104887,22,132,0,5,0,0,159,16.981132075471695,3.649635036496346
35104899,726,192,0,4,2,3,927,79.28802588996764,4.477611940298509
35104917,358,941,0,16,13,0,1328,29.141566265060238,2.989690721649485
35104985,612,1779,9,29,210,0,2639,32.5881015536188,12.23482979773064
35104991,922,568,3,22,37,0,1552,63.4020618556701,9.84126984126984
35105028,136,479,3,12,23,0,653,26.64624808575804,7.350096711798837
35105041,64,336,3,9,13,1,426,21.126760563380287,7.182320441988955
35105053,221,520,8,23,49,0,821,36.662606577344704,13.33333333333333
35105077,61,301,4,11,54,0,431,30.162412993039446,18.648648648648646
35105132,84,539,3,6,25,1,658,18.085106382978722,6.0975609756097615
35105272,4,64,0,0,0,0,68,5.882352941176472,0
35105302,56,211,0,4,9,0,280,24.642857142857146,5.803571428571431
35105314,290,956,2,21,14,1,1284,25.545171339563865,3.82293762575453
35105338,47,4,0,0,0,0,51,92.15686274509804,0
35105348,38,75,0,0,3,0,116,35.3448275862069,3.8461538461538436
35105429,130,244,1,34,2,0,411,40.63260340632603,13.16725978647687
35105521,168,253,4,5,3,0,433,41.570438799076214,4.528301886792452
35105545,506,246,0,4,17,1,774,68.21705426356588,8.208955223880599
35105569,176,385,0,6,0,0,567,32.098765432098766,1.534526854219953
35105600,150,1017,2,56,9,0,1234,17.58508914100486,6.180811808118081
35105648,643,2362,2,12,33,1,3053,22.63347527022601,1.991701244813282
35105685,31,174,0,2,7,0,214,18.691588785046733,4.918032786885251
35105797,14,21,1,5,0,0,41,48.78048780487805,22.22222222222222
35105806,34,81,2,3,3,0,123,34.14634146341463,8.98876404494382
35105818,162,468,10,45,3,0,688,31.976744186046513,11.026615969581755
35105909,4,146,0,0,0,0,150,2.6666666666666616,0
35105910,82,370,1,7,1,0,461,19.73969631236443,2.37467018469657
35105961,78,643,2,17,9,0,749,14.152202937249669,4.172876304023843
35105971,148,144,0,8,1,0,301,52.159468438538205,5.882352941176472
35105995,49,43,0,1,0,0,93,53.76344086021505,2.2727272727272707
35106008,157,79,0,1,0,0,237,66.66666666666667,1.2499999999999956
35106124,22,142,1,2,0,0,167,14.970059880239518,2.0689655172413834
35106148,315,1846,4,11,13,0,2189,15.669255367747825,1.4941302027748127
35106159,162,244,6,25,10,0,447,45.41387024608501,14.385964912280702
35106161,53,361,1,3,36,0,454,20.48458149779736,9.975062344139651
35106240,85,332,6,12,3,0,438,24.200913242009136,5.9490084985835745
35106367,108,378,1,7,6,0,500,24.4,3.57142857142857
35106446,614,2318,4,11,28,1,2976,22.110215053763437,1.8628281117696877
35106471,26,190,3,10,3,0,232,18.103448275862068,7.7669902912621325
35106513,6,137,1,4,8,0,156,12.17948717948718,8.666666666666668
35106550,25,45,2,9,5,0,86,47.67441860465116,26.22950819672131
35106616,169,854,10,28,31,0,1092,21.794871794871796,7.475622968580719
35106628,79,608,10,30,14,0,741,17.948717948717952,8.157099697885196
35106636,292,715,13,108,9,0,1137,37.115215479331574,15.384615384615385
35106677,117,303,5,70,5,0,500,39.4,20.88772845953003
35106732,33,165,2,10,6,0,216,23.611111111111114,9.836065573770492
35106756,185,743,0,20,24,0,972,23.559670781893004,5.590851334180435
35106768,450,235,6,22,3,0,716,67.17877094972067,11.654135338345862
35106781,107,362,5,37,15,0,526,31.1787072243346,13.603818615751795
35106800,131,436,7,58,6,0,638,31.661442006269592,14.003944773175547
35106811,193,594,2,35,21,0,845,29.70414201183432,8.895705521472397
35106823,59,149,5,16,8,0,237,37.130801687763714,16.292134831460668
35106884,306,781,9,41,55,0,1192,34.47986577181208,11.851015801354404
35106896,23,518,7,13,102,0,663,21.87028657616893,19.062500000000004
35106926,325,851,30,174,148,3,1531,44.41541476159373,29.436152570480935
35106999,144,127,2,30,27,1,331,61.631419939577036,32.085561497326196
35107049,1343,429,8,46,5,3,1834,76.60850599781898,12.627291242362526
35107050,162,238,6,14,7,0,427,44.26229508196722,10.188679245283016
35107074,199,337,22,95,4,0,657,48.7062404870624,26.419213973799128
35107116,144,544,4,16,26,0,734,25.88555858310627,7.796610169491524
35107128,65,292,10,13,22,0,402,27.363184079601986,13.353115727002962
35107153,102,211,12,51,2,2,380,44.47368421052632,24.100719424460426
35107165,138,364,1,8,321,0,832,56.25,47.55043227665706
35107177,556,2202,10,40,82,3,2893,23.88524023505012,5.776636713735561
35107190,222,1478,7,28,71,0,1806,18.161683277962346,6.691919191919194
35107219,120,481,3,19,11,0,634,24.132492113564673,6.420233463035019
35107256,66,266,3,7,10,0,352,24.431818181818176,6.99300699300699
35107273,15,76,5,13,7,0,116,34.48275862068966,24.752475247524753
35107335,67,210,7,32,1,0,317,33.753943217665615,16.000000000000004
35107347,74,285,1,4,11,0,375,24,5.3156146179402
35107360,82,100,2,15,2,0,201,50.24875621890548,15.966386554621847
35107396,52,80,3,7,10,0,152,47.36842105263158,19.999999999999996
35107402,705,389,6,22,40,1,1163,66.55202063628548,15.06550218340611
35107414,213,226,1,7,6,0,453,50.11037527593819,5.833333333333335
35107438,20,158,2,2,5,0,187,15.508021390374328,5.389221556886225
35107475,201,304,1,10,5,0,521,41.65067178502879,5.000000000000004
35107487,517,558,2,13,8,0,1098,49.18032786885246,3.9586919104991347
35107499,88,392,5,15,3,1,504,22.22222222222222,5.769230769230771
35107517,1732,1041,29,297,17,1,3117,66.60250240615977,24.83754512635379
35107529,157,171,6,77,1,1,413,58.595641646489106,33.203125
35107542,268,821,2,5,13,0,1109,25.969341749323714,2.378121284185497
35107554,339,163,2,43,3,0,550,70.36363636363636,22.748815165876778
35107566,22,240,12,111,1,0,386,37.82383419689119,34.065934065934066
35107578,151,315,8,40,5,0,519,39.30635838150289,14.40217391304348
35107585,109,388,16,55,1,0,569,31.810193321616875,15.652173913043477
35107591,224,669,33,247,2,2,1177,43.16057774001699,29.800629590766004
35107608,435,505,24,151,3,0,1118,54.830053667262966,26.0614934114202
35107612,244,352,7,82,1,0,686,48.68804664723032,20.36199095022625
35107621,186,371,20,195,2,1,775,52.12903225806451,37.01188455008489
35107633,487,643,15,112,10,1,1268,49.290220820189276,17.669654289372595
35107645,221,606,30,190,7,1,1055,42.55924170616113,27.338129496402875
35107657,206,354,25,148,5,0,738,52.032520325203244,33.45864661654135
35107669,222,399,29,237,2,0,889,55.118110236220474,40.179910044977504
35107682,793,1237,60,369,6,2,2467,49.858127280097285,26.105137395459977
35107700,379,326,1,8,1,0,715,54.40559440559441,2.9761904761904767
35107724,109,423,22,144,3,0,701,39.657631954350926,28.547297297297302
35107736,97,586,2,13,9,0,707,17.114568599717117,3.934426229508192
35107759,503,138,22,141,2,1,807,82.8996282527881,54.60526315789473
35107773,434,324,0,2,2,0,762,57.48031496062992,1.2195121951219523
35107785,27,81,1,26,0,0,135,40,25
35107803,237,526,1,24,11,0,799,34.16770963704631,6.4056939501779375
35107827,123,131,12,37,2,1,306,57.18954248366013,28.415300546448087
35107888,299,125,0,3,3,0,430,70.93023255813952,4.580152671755721
35107906,224,965,14,87,7,2,1299,25.71208622016936,10.232558139534886
35107924,178,214,8,52,1,0,453,52.75938189845475,22.18181818181818
35107967,63,162,1,6,78,0,310,47.74193548387097,34.412955465587046
35112987,101,239,15,20,1,0,376,36.43617021276596,13.090909090909086
35113074,90,133,5,86,1,1,316,57.91139240506329,41.150442477876105
35113141,15,37,1,4,0,0,57,35.08771929824561,11.904761904761907
35113529,553,106,7,46,1,1,714,85.15406162464986,34.161490683229815
35113566,113,38,6,127,0,0,284,86.61971830985915,77.77777777777779
35114339,456,128,18,88,0,1,691,81.47612156295224,45.53191489361702
35115307,192,135,7,23,0,0,357,62.18487394957983,18.181818181818176
35115423,50,39,3,8,0,0,100,61,21.999999999999996
35115460,16,26,3,5,0,0,50,48,23.529411764705888
35117729,51,71,1,32,0,0,155,54.19354838709678,31.73076923076923
35117869,41,89,9,46,3,0,188,52.65957446808511,39.455782312925166
35117894,212,117,7,87,0,0,423,72.34042553191489,44.54976303317536
35117912,90,280,6,63,4,0,443,36.79458239277652,20.679886685552407
35117924,33,214,7,9,3,0,266,19.548872180451127,8.154506437768239
35118148,191,51,4,33,0,0,279,81.72043010752688,42.04545454545454
35118151,169,45,1,8,1,0,224,79.91071428571428,18.181818181818176
35118163,20,98,0,3,0,0,121,19.00826446280992,2.970297029702973
35118345,19,183,2,16,1,0,221,17.194570135746613,9.405940594059404
35118357,58,128,13,19,2,1,221,42.0814479638009,21.47239263803681
35118679,111,169,4,26,0,1,311,45.659163987138264,15.500000000000004
35118758,63,460,6,15,6,0,550,16.36363636363637,5.544147843942504
35118761,102,114,1,5,3,0,225,49.33333333333333,7.317073170731703
35118898,90,323,1,0,0,0,414,21.980676328502412,0.30864197530864335
35118928,345,479,5,7,5,0,841,43.04399524375743,3.427419354838712
35118936,117,69,2,5,2,0,195,64.61538461538461,11.538461538461542
35118977,184,404,12,41,1,0,642,37.071651090342684,11.790393013100442
35118989,95,251,6,32,3,0,387,35.1421188630491,14.04109589041096
35118990,174,318,5,52,3,0,552,42.391304347826086,15.873015873015872
35119015,36,107,2,3,0,0,148,27.702702702702698,4.46428571428571
35119039,166,382,3,11,8,0,570,32.98245614035088,5.44554455445545
35119040,96,495,4,18,17,0,630,21.42857142857143,7.303370786516849
35119052,74,178,2,0,0,1,255,30.196078431372552,1.6574585635359074
35119076,23,70,3,3,2,0,101,30.6930693069307,10.256410256410254
35119106,54,225,3,4,1,1,288,21.875,3.8461538461538436
35119118,110,217,3,25,3,2,360,39.72222222222223,13.200000000000001
35119124,48,264,6,12,7,0,337,21.661721068249264,8.650519031141869
35119192,122,284,12,26,1,0,445,36.17977528089887,12.074303405572751
35119209,225,338,3,41,1,0,608,44.4078947368421,11.749347258485642
35119210,56,82,4,32,1,1,176,53.40909090909092,31.666666666666664
35119222,206,344,15,84,3,0,652,47.239263803680984,22.869955156950674
35119234,117,47,2,12,0,0,178,73.59550561797754,22.95081967213115
35119261,47,962,60,246,5,0,1320,27.121212121212125,24.430479183032205
35119271,18,49,0,0,2,0,69,28.985507246376805,3.9215686274509776
35119295,194,174,12,64,2,2,448,61.16071428571428,31.496062992125985
35119350,9,19,0,0,32,0,60,68.33333333333333,62.745098039215684
35119374,23,94,0,3,1,0,121,22.314049586776864,4.081632653061229
35119386,27,22,2,4,2,0,57,61.40350877192983,26.66666666666667
35119404,158,120,5,17,0,0,300,60,15.492957746478876
35119453,33,148,0,4,211,0,396,62.62626262626263,59.22865013774105
35119969,53,348,4,9,4,0,418,16.74641148325359,4.657534246575345
35119982,131,537,0,10,8,0,686,21.720116618075803,3.2432432432432434
35120017,9,39,2,4,2,0,56,30.35714285714286,17.021276595744684
35120029,22,153,2,15,0,0,192,20.3125,9.999999999999998
35120030,171,269,2,21,1,0,464,42.025862068965516,8.19112627986348
35120112,6,54,0,6,1,0,67,19.402985074626866,11.475409836065575
35120145,3,103,1,7,2,0,116,11.206896551724132,8.849557522123897
35120169,274,67,0,3,0,1,345,80.57971014492753,5.633802816901412
35120285,594,906,1,6,12,0,1519,40.35549703752469,2.0540540540540553
35120297,2,39,0,1,3,0,45,13.33333333333333,9.302325581395355
35120327,4,273,1,3,9,0,290,5.862068965517242,4.545454545454541
35120339,67,190,2,11,62,0,332,42.77108433734939,28.301886792452834
35120376,35,65,2,25,0,0,127,48.818897637795274,29.34782608695652
35120406,121,595,14,65,12,0,807,26.27013630731103,13.265306122448983
35120418,0,24,2,20,0,0,46,47.82608695652174,47.82608695652174
35121459,69,46,3,37,0,0,155,70.3225806451613,46.51162790697675
35121460,14,43,1,13,0,0,71,39.43661971830986,24.561403508771928
35121484,154,131,18,172,3,0,478,72.59414225941423,59.5679012345679
35121642,46,11,1,8,0,0,66,83.33333333333334,44.99999999999999
35121708,105,29,2,19,0,0,155,81.29032258064515,42.00000000000001
35121964,23,226,21,116,0,1,387,41.60206718346253,37.91208791208791
35121976,18,48,4,53,0,0,123,60.97560975609756,54.28571428571429
35121988,49,31,2,19,0,0,101,69.3069306930693,40.38461538461539
35122063,101,663,56,466,4,2,1292,48.68421052631579,44.33249370277078
35122075,83,117,17,191,2,0,410,71.46341463414633,64.22018348623853
35122658,322,99,7,72,0,0,500,80.2,44.38202247191011
35123493,2,60,0,2,0,0,64,6.25,3.2258064516129004
35123785,1,77,0,3,0,0,81,4.938271604938271,3.749999999999998
35123869,18,63,0,9,1,0,91,30.76923076923077,13.698630136986301
35123973,26,53,4,7,1,0,91,41.75824175824175,18.461538461538463
35124175,115,157,3,5,3,0,283,44.52296819787986,6.547619047619047
35124199,1332,1064,2,117,51,1,2567,58.55083755356447,13.846153846153841
35124278,9,66,0,4,0,0,79,16.455696202531644,5.714285714285716
35124291,97,62,1,2,6,0,168,63.095238095238095,12.676056338028175
35124400,95,132,2,9,0,0,238,44.53781512605042,7.692307692307687
35124436,120,346,8,44,0,0,518,33.204633204633204,13.06532663316583
35124448,132,196,9,67,1,1,406,51.72413793103448,28.467153284671532
35124459,361,316,6,41,2,1,727,56.53370013755158,13.661202185792353
35124527,298,143,2,11,1,1,456,68.64035087719299,9.493670886075945
35124576,345,250,10,35,6,1,647,61.360123647604325,17.218543046357617
35124655,183,53,0,0,0,0,236,77.54237288135593,0
35124709,75,235,6,27,0,0,343,31.4868804664723,12.313432835820892
35124795,335,351,8,312,2,1,1009,65.21308225966303,47.92284866468842
35124849,30,63,1,7,4,0,105,40,16.000000000000004
35124989,70,413,2,11,3,0,499,17.234468937875747,3.7296037296037254
35125398,299,251,3,9,15,0,577,56.499133448873486,9.712230215827333
35125428,10,28,0,5,1,0,44,36.36363636363637,17.647058823529417
35125726,165,298,18,85,4,0,570,47.71929824561404,26.41975308641975
35125829,82,102,6,41,0,0,231,55.84415584415585,31.543624161073826
35125891,143,121,0,5,2,0,271,55.35055350553506,5.46875
35125908,77,441,6,26,36,0,586,24.74402730375427,13.359528487229866
35126020,51,53,1,21,0,0,126,57.93650793650793,29.333333333333332
35126068,50,56,3,22,1,1,133,57.89473684210527,32.53012048192772
35126093,107,225,97,469,2,0,900,75,71.62673392181588
35126123,67,175,3,10,8,0,263,33.460076045627375,10.71428571428571
35126147,257,26,0,1,1,0,285,90.87719298245614,7.14285714285714
35126342,1,51,1,1,0,0,54,5.555555555555558,3.7735849056603765
35126366,128,471,9,13,1,1,623,24.39807383627608,4.848484848484846
35126421,67,163,5,26,81,0,342,52.33918128654971,40.72727272727272
35126512,82,107,5,26,3,0,223,52.01793721973094,24.113475177304966
35126536,23,116,0,4,0,2,145,19.999999999999996,4.918032786885251
35126548,6,156,0,0,2,0,164,4.878048780487809,1.2658227848101222
35126676,105,118,13,109,0,0,345,65.79710144927536,50.83333333333333
35126718,57,164,0,2,1,0,224,26.785714285714292,1.7964071856287456
35126724,422,208,3,3,21,0,657,68.34094368340944,11.489361702127665
35126810,2,38,0,0,7,0,47,19.14893617021277,15.555555555555555
35126822,52,44,1,7,1,0,105,58.09523809523809,16.981132075471695
35127000,73,89,9,32,0,0,203,56.15763546798029,31.538461538461537
35127140,119,105,4,253,0,0,481,78.17047817047818,70.99447513812154
35127197,98,91,2,13,2,1,207,56.038647342995176,16.51376146788991
35127206,43,48,0,1,0,0,92,47.82608695652174,2.0408163265306145
35127218,34,91,0,8,0,0,133,31.57894736842105,8.080808080808078
35127224,62,113,0,2,0,0,177,36.15819209039548,1.7391304347826098
35127231,174,333,20,44,6,2,579,42.48704663212435,17.777777777777782
35127255,19,45,2,5,0,0,71,36.61971830985915,13.461538461538458
35127929,100,23,5,26,0,0,154,85.06493506493507,57.407407407407405
35127966,17,37,1,0,0,0,55,32.72727272727273,2.631578947368418
35127978,63,53,0,11,0,1,128,58.59375,18.461538461538463
35127991,306,812,7,32,1,1,1159,29.93960310612597,4.806565064478308
35128144,6,65,4,14,2,0,91,28.57142857142857,23.529411764705888
35128235,13,62,7,69,0,0,151,58.94039735099338,55.072463768115945
35128260,60,48,1,24,0,0,133,63.90977443609023,34.24657534246576
35128296,57,19,6,30,0,0,112,83.03571428571428,65.45454545454545
35128351,55,60,2,42,1,0,160,62.5,42.85714285714286
35128363,16,20,2,28,0,0,66,69.6969696969697,60
35128387,96,78,10,24,1,0,209,62.67942583732058,30.973451327433633
35128818,42,26,3,57,0,0,128,79.6875,69.76744186046511
35128879,4,145,0,3,1,0,153,5.228758169934644,2.684563758389258
35128934,135,116,15,42,1,0,309,62.45954692556634,33.333333333333336
35129008,118,187,8,59,2,0,374,50,26.953125
35129159,74,143,1,19,0,0,237,39.662447257383974,12.269938650306745
35129173,31,98,7,20,0,0,156,37.17948717948718,21.599999999999998
35129185,390,407,14,94,3,0,908,55.17621145374449,21.42857142857143
35129288,57,27,4,11,1,0,100,73,37.2093023255814
35129392,77,2,0,0,0,0,79,97.46835443037975,0
35129550,49,96,7,37,1,0,190,49.473684210526315,31.914893617021278
35129628,33,45,0,13,0,1,92,51.08695652173913,23.728813559322038
35129653,50,71,3,23,0,0,147,51.70068027210885,26.80412371134021
35129756,20,42,2,32,0,0,96,56.25,44.73684210526315
35129793,40,2,0,1,0,0,43,95.34883720930233,33.333333333333336
35129811,23,104,5,14,0,1,147,29.25170068027211,16.129032258064512
35129859,20,23,0,1,0,0,44,47.72727272727273,4.1666666666666625
35129926,7,65,2,15,0,0,89,26.96629213483146,20.731707317073166
35129938,43,96,3,31,0,0,173,44.50867052023122,26.15384615384615
35129948,19,106,2,4,3,0,134,20.895522388059707,7.826086956521738
35129999,169,53,1,82,0,0,305,82.62295081967213,61.029411764705884
35130000,34,47,0,9,0,0,90,47.77777777777777,16.07142857142857
35130175,39,127,0,0,6,0,172,26.16279069767442,4.511278195488721
35130199,47,25,2,12,0,0,86,70.93023255813952,35.89743589743589
35130205,106,168,4,13,13,1,305,44.91803278688524,15.577889447236181
35130217,179,624,2,3,3,0,811,23.057953144266342,1.2658227848101222
35130254,77,107,2,4,10,0,200,46.5,13.008130081300816
35130321,266,340,35,227,1,1,870,60.91954022988506,43.70860927152318
35130333,141,245,31,209,2,1,629,61.04928457869634,49.795081967213115
35130369,156,121,0,6,0,0,283,57.24381625441697,4.7244094488189
35130382,222,215,22,103,3,0,565,61.946902654867266,37.31778425655977
35130459,29,52,2,15,1,0,99,47.47474747474747,25.71428571428571
35130497,4,93,0,2,1,0,100,6.999999999999995,3.125
35130540,435,1260,31,245,250,5,2226,43.39622641509434,29.648241206030146
35130758,410,721,12,126,15,1,1285,43.89105058365759,17.600000000000005
35131088,16,23,0,9,0,0,48,52.08333333333333,28.125
35131283,176,124,10,140,2,2,454,72.68722466960352,55.39568345323741
35131416,43,25,2,2,0,0,72,65.27777777777779,13.793103448275868
35131507,90,169,0,2,1,0,262,35.49618320610687,1.744186046511631
35131520,256,167,26,95,2,3,549,69.58105646630237,43.003412969283275
35131544,113,102,10,75,0,1,301,66.11295681063123,45.74468085106383
35131556,135,98,9,40,2,0,284,65.49295774647888,34.22818791946308
35131659,16,48,1,3,0,0,68,29.411764705882348,7.692307692307687
35131660,293,853,8,24,60,0,1238,31.09854604200323,9.73544973544973
35131738,163,336,4,12,8,0,523,35.75525812619503,6.666666666666665
35131775,71,16,2,12,0,0,101,84.15841584158416,46.666666666666664
35131787,101,162,8,19,8,0,298,45.63758389261745,17.76649746192893
35131799,94,307,20,40,1,0,462,33.549783549783555,16.576086956521742
35131805,58,383,3,9,13,0,466,17.811158798283266,6.127450980392157
35131885,48,16,3,29,0,0,96,83.33333333333334,66.66666666666667
35131891,135,333,0,0,2,0,470,29.14893617021277,0.5970149253731294
35131912,22,48,0,4,0,0,74,35.13513513513513,7.692307692307687
35132196,31,338,1,13,16,0,399,15.288220551378451,8.15217391304348
35132214,121,454,2,18,17,0,612,25.816993464052285,7.535641547861505
35132287,130,249,5,5,17,1,407,38.82063882063882,10.108303249097473
35132317,29,19,4,2,0,0,54,64.81481481481481,24
35132329,103,129,3,11,1,0,247,47.773279352226716,10.416666666666663
35132559,191,419,3,6,25,0,644,34.93788819875776,7.505518763796914
35132561,18,25,2,4,3,0,52,51.92307692307692,26.470588235294112
35132986,63,324,5,59,5,0,456,28.947368421052634,17.557251908396942
35133152,32,187,12,18,2,0,251,25.49800796812749,14.61187214611872
35133176,70,229,4,20,3,0,326,29.75460122699386,10.546875
35133188,1,41,0,0,2,0,44,6.818181818181824,4.651162790697672
35133346,54,311,5,11,3,0,384,19.010416666666664,5.757575757575761
35133395,128,326,4,19,36,0,513,36.452241715399616,15.32467532467533
35133401,282,398,39,110,1,1,831,52.10589651022863,27.504553734061933
35133449,40,98,3,10,14,0,165,40.6060606060606,21.599999999999998
35133450,79,211,2,9,10,0,311,32.154340836012864,9.05172413793104
35133462,216,199,2,21,3,0,441,54.87528344671202,11.555555555555552
35133498,178,221,12,32,0,0,443,50.112866817155755,16.603773584905657
35133504,415,123,19,132,1,2,692,82.22543352601156,55.5956678700361
35133541,94,188,4,36,0,0,322,41.61490683229814,17.543859649122805
35133565,83,262,1,9,4,0,359,27.019498607242344,5.072463768115942
35133991,375,118,1,3,3,1,501,76.44710578842316,6.349206349206349
35134065,73,311,0,5,8,0,397,21.662468513853906,4.012345679012341
35134119,145,737,1,9,3,1,896,17.745535714285708,1.8641810918774926
35134120,55,85,0,3,0,0,143,40.55944055944056,3.409090909090906
35134132,59,201,2,4,25,0,291,30.927835051546392,13.362068965517238
35134144,49,31,2,137,0,0,219,85.84474885844749,81.76470588235294
35134569,154,332,8,28,3,0,525,36.76190476190476,10.512129380053903
35134594,53,123,0,6,4,0,186,33.87096774193549,7.518796992481203
35134673,220,511,12,43,1,1,788,35.15228426395939,10.035211267605638
35134788,136,220,0,5,1,0,362,39.226519337016576,2.6548672566371723
35134806,777,1488,11,50,624,1,2951,49.576414774652655,31.554737810487577
35134879,64,44,0,0,0,0,108,59.25925925925925,0
35134958,64,144,2,27,0,0,237,39.24050632911392,16.763005780346816
35134983,61,70,3,2,1,0,137,48.90510948905109,7.8947368421052655
35135021,158,162,2,14,1,0,337,51.92878338278932,9.49720670391061
35135057,117,338,5,29,8,0,497,31.991951710261567,11.05263157894737
35135380,93,187,5,12,0,1,298,37.248322147651,8.780487804878046
35135434,53,358,6,17,1,1,436,17.889908256880737,6.5274151436031325
35135446,314,311,11,32,4,0,672,53.720238095238095,13.128491620111726
35135461,24,186,0,40,2,0,252,26.190476190476186,18.42105263157895
35135471,80,189,4,10,1,0,284,33.45070422535211,7.352941176470584
35135483,30,57,2,1,0,0,90,36.66666666666667,5.000000000000004
35135525,559,119,3,15,4,0,700,83,15.602836879432624
35135549,378,563,27,103,7,1,1079,47.822057460611674,19.68616262482168
35135550,201,76,4,12,1,0,294,74.14965986394557,18.279569892473113
35135562,190,311,3,54,2,0,560,44.46428571428571,15.94594594594595
35136189,98,1016,0,2,0,0,1116,8.960573476702505,0.19646365422396617
35136232,49,61,0,1,0,0,111,45.04504504504504,1.6129032258064502
35136268,48,55,5,27,1,0,136,59.55882352941176,37.5
35136293,208,56,0,0,0,0,264,78.78787878787878,0
35136335,135,459,0,4,21,1,620,25.96774193548387,5.360824742268044
35136359,218,308,11,97,5,1,640,51.87500000000001,27.014218009478675
35136396,82,275,1,10,1,0,369,25.47425474254743,4.181184668989546
35136463,155,507,8,24,16,0,710,28.591549295774644,8.64864864864865
35136566,31,121,0,4,45,0,201,39.80099502487562,28.823529411764703
35136608,59,225,1,5,14,0,304,25.986842105263154,8.163265306122447
35136669,21,69,3,3,4,0,100,31.000000000000007,12.658227848101266
35136897,30,388,0,1,11,0,430,9.76744186046512,3.0000000000000027
35136906,64,257,4,9,2,0,336,23.511904761904766,5.514705882352944
35136918,26,136,1,2,1,0,166,18.07228915662651,2.857142857142858
35136931,604,3248,30,57,322,0,4261,23.773762027693035,11.18403062619634
35136943,235,273,9,90,4,1,612,55.392156862745104,27.586206896551722
35137030,3,109,0,0,0,0,112,2.67857142857143,0
35137042,138,583,8,29,67,0,825,29.333333333333332,15.138282387190682
35137066,52,319,1,6,4,0,382,16.492146596858635,3.3333333333333326
35137078,156,154,7,41,0,1,359,57.10306406685237,24.13793103448276
35137085,145,89,3,23,0,0,260,65.76923076923077,22.608695652173914
35137108,310,314,16,119,1,1,761,58.73850197109067,30.37694013303769
35137133,381,683,5,9,6,0,1084,36.99261992619927,2.8449502133712667
35137157,29,97,2,5,1,1,135,28.148148148148145,8.490566037735848
35137397,140,562,3,17,13,0,735,23.537414965986393,5.5462184873949605
35137406,115,500,0,4,22,0,641,21.996879875195006,4.942965779467679
35137418,107,319,3,25,3,0,457,30.196936542669583,8.857142857142852
35137455,67,207,1,2,3,0,280,26.07142857142857,2.8169014084507005
35137509,42,28,0,0,0,0,70,60,0
35137534,88,129,10,26,0,0,253,49.011857707509876,21.818181818181813
35137546,239,333,5,40,5,1,623,46.54895666131621,13.28125
35138198,50,229,3,13,0,2,297,22.895622895622893,7.287449392712553
35138216,46,325,3,10,3,0,387,16.020671834625322,4.692082111436946
35138241,71,60,2,5,1,0,139,56.83453237410072,11.764705882352944
35138253,46,130,3,7,2,0,188,30.85106382978723,8.450704225352112
35138265,49,74,0,7,0,0,130,43.07692307692308,8.64197530864198
35138435,15,210,0,8,1,2,236,11.016949152542377,4.977375565610864
35138502,5,157,0,0,0,0,162,3.0864197530864224,0
35138526,61,239,1,7,9,0,317,24.60567823343849,6.640625
35138538,9,101,5,3,5,0,123,17.886178861788615,11.403508771929827
35138548,1,60,0,0,0,0,61,1.6393442622950838,0
35138575,112,1002,4,48,52,0,1218,17.733990147783253,9.40325497287523
35138605,72,121,5,20,1,0,219,44.74885844748858,17.68707482993197
35138885,712,79,0,1,3,0,795,90.062893081761,4.81927710843374
35138903,116,176,1,1,1,0,295,40.33898305084745,1.6759776536312887
35138915,92,114,1,3,0,0,210,45.714285714285715,3.3898305084745783
35138940,3,48,1,1,0,0,53,9.433962264150942,4.0000000000000036
35138988,129,160,10,25,1,0,325,50.76923076923077,18.36734693877551
35139038,117,562,3,15,8,0,705,20.283687943262407,4.4217687074829986
35139051,58,110,2,10,1,0,181,39.226519337016576,10.569105691056912
35139063,74,195,8,12,8,0,297,34.34343434343434,12.556053811659195
35139099,87,102,1,11,8,0,209,51.196172248803826,16.393442622950815
35139129,1077,795,36,153,103,16,2180,63.53211009174312,27.92384406165005
35139221,312,466,4,23,9,0,814,42.75184275184275,7.171314741035861
35139233,35,810,28,115,4,1,993,18.429003021148038,15.44885177453027
35139245,1,87,0,7,4,0,99,12.121212121212121,11.22448979591837
35139403,148,73,11,19,2,1,254,71.25984251968505,31.132075471698116
35139497,151,1031,4,8,16,0,1210,14.793388429752063,2.6440037771482516
35139580,607,374,4,36,7,0,1028,63.61867704280155,11.163895486935871
35139661,12,45,1,2,0,0,60,25,6.25
35139774,305,492,21,70,3,1,892,44.84304932735426,16.1839863713799
35139798,88,146,11,18,1,0,264,44.6969696969697,17.04545454545454
35139804,327,255,14,100,1,0,697,63.41463414634146,31.081081081081084
35139877,19,51,1,10,1,0,82,37.80487804878049,19.047619047619047
35140004,421,210,5,27,5,0,668,68.562874251497007,14.979757085020239
35140200,46,100,2,6,1,0,155,35.483870967741936,8.25688073394495
35140302,3,108,0,1,0,0,112,3.57142857142857,0.917431192660545
35140314,539,267,9,65,5,1,886,69.86455981941309,23.054755043227672
35140326,148,151,9,62,1,0,371,59.299191374663074,32.28699551569507
35140338,269,751,1,11,9,0,1041,27.85782901056676,2.720207253886009
35140348,205,452,3,19,15,0,694,34.87031700288185,7.566462167689158
35140351,112,395,1,15,14,2,539,26.716141001855288,7.4941451990632295
35140363,25,101,0,4,1,0,131,22.90076335877863,4.716981132075471
35140521,3,57,0,1,1,0,62,8.064516129032262,3.3898305084745783
35140740,68,107,5,15,1,0,196,45.40816326530612,16.40625
35140776,4,179,0,1,0,0,184,2.717391304347827,0.5555555555555536
35140788,30,239,0,3,2,0,274,12.773722627737227,2.049180327868849
35140880,519,458,11,27,5,2,1022,55.18590998043054,8.946322067594437
35141203,32,329,0,0,2,0,363,9.366391184572997,0.6042296072507503
35141239,16,53,1,11,0,0,81,34.5679012345679,18.461538461538463
35141240,115,315,0,4,15,0,449,29.84409799554566,5.688622754491012
35141264,36,471,2,11,10,0,530,11.13207547169811,4.655870445344135
35141276,101,336,2,22,18,0,479,29.85386221294363,11.111111111111116
35141297,167,294,6,55,2,0,524,43.89312977099237,17.647058823529417
35141331,25,60,4,3,3,0,95,36.8421052631579,14.28571428571429
35141446,81,440,8,30,8,1,568,22.535211267605636,9.650924024640661
35141483,141,780,14,55,5,2,997,21.765295887662994,8.878504672897192
35141689,180,382,4,39,6,1,612,37.58169934640523,11.574074074074069
35141768,242,161,6,68,2,0,479,66.38830897703549,32.0675105485232
35141773,150,739,26,118,10,0,1043,29.146692233940552,17.245240761478165
35141860,57,75,0,2,15,0,149,49.66442953020134,18.478260869565222
35141884,40,147,3,34,11,0,235,37.4468085106383,24.615384615384617
35141902,19,56,2,9,0,0,86,34.883720930232556,16.417910447761198
35141948,28,150,0,3,0,0,181,17.12707182320442,1.9607843137254943
35142013,283,408,4,10,4,0,709,42.45416078984485,4.225352112676061
35142025,45,166,9,22,0,0,242,31.404958677685947,15.736040609137058
35142037,16,36,0,4,1,0,57,36.8421052631579,12.195121951219512
35142050,77,5,0,0,0,0,82,93.90243902439023,0
35142220,138,204,7,58,0,0,407,49.877149877149876,24.1635687732342
35142311,252,107,4,22,1,0,386,72.279792746114,20.149253731343286
35142323,58,220,2,12,7,0,299,26.42140468227425,8.713692946058094
35142505,177,287,8,10,2,1,485,40.824742268041234,6.818181818181824
35142529,152,317,3,35,2,1,510,37.84313725490196,11.45251396648045
35142669,56,182,0,9,128,0,375,51.46666666666666,42.94670846394985
35142700,47,223,5,12,4,0,291,23.367697594501713,8.606557377049185
35142724,150,464,20,100,15,0,749,38.05073431241656,22.537562604340565
35142736,58,437,2,11,8,0,516,15.310077519379849,4.585152838427953
35142759,507,733,8,34,3,0,1285,42.95719844357977,5.784061696658094
35142864,89,230,8,26,14,0,367,37.32970027247956,17.266187050359715
35142876,152,255,21,366,2,0,796,67.96482412060301,60.40372670807454
35142888,134,195,18,55,2,0,404,51.73267326732673,27.77777777777778
35143042,322,285,7,35,6,0,655,56.48854961832062,14.414414414414411
35143157,145,512,5,10,3,0,675,24.148148148148152,3.396226415094339
35143200,180,607,7,19,20,1,834,27.218225419664265,7.18654434250765
35143248,36,42,0,0,0,0,78,46.15384615384615,0
35143397,136,129,2,14,3,0,284,54.5774647887324,12.83783783783784
35143406,501,233,1,3,8,0,746,68.76675603217159,4.897959183673473
35143571,124,404,6,21,5,0,560,27.857142857142858,7.339449541284404
35143583,78,56,2,14,0,0,150,62.66666666666667,22.22222222222222
35143595,275,319,5,27,3,2,631,49.44532488114105,10.39325842696629
35143649,11,58,1,4,0,0,74,21.62162162162162,7.936507936507942
35143873,28,64,3,4,2,0,101,36.633663366336634,12.328767123287676
35143959,621,406,22,124,8,0,1181,65.622353937341245,27.500000000000004
35144186,258,221,2,6,4,1,492,55.08130081300813,5.555555555555558
35144228,111,368,4,13,152,0,648,43.20987654320988,31.471135940409678
35144241,429,395,14,93,0,0,931,57.57250268528465,21.314741035856578
35144307,118,173,6,54,3,0,354,51.12994350282486,26.694915254237284
35144435,89,176,7,47,1,0,320,44.99999999999999,23.809523809523814
35144459,99,300,2,63,10,0,474,36.70886075949367,19.999999999999996
35144708,196,387,1,6,2,0,592,34.62837837837838,2.2727272727272707
35144721,408,187,5,18,1,0,619,69.78998384491115,11.374407582938383
35144824,105,226,3,1,1,0,336,32.738095238095234,2.164502164502169
35144952,553,723,18,93,20,2,1409,48.68701206529453,15.537383177570096
35145002,0,113,8,42,0,0,163,30.67484662576687,30.67484662576687
35145038,26,40,1,17,0,2,86,53.48837209302326,33.333333333333336
35146286,100,36,10,33,0,0,179,79.88826815642457,54.43037974683544
35146961,19,28,5,12,1,0,65,56.92307692307692,39.13043478260869
35147394,35,27,0,12,1,0,75,64,32.49999999999999
35147412,69,63,10,27,0,1,170,62.94117647058823,37.62376237623762
35147758,251,362,17,154,3,1,788,54.06091370558376,32.58845437616388
35147771,47,64,3,24,1,0,139,53.956834532374096,30.434782608695656
35147795,47,108,6,31,0,0,192,43.75,25.51724137931034
35147801,158,241,13,93,6,0,511,52.837573385518596,31.728045325779043
35147813,110,81,8,34,4,0,237,65.82278481012658,36.22047244094488
35147825,83,128,15,40,2,2,270,52.59259259259259,31.550802139037437
35147849,115,123,7,35,5,0,285,56.84210526315789,27.647058823529413
35147850,84,94,8,52,1,0,239,60.66945606694561,39.35483870967742
35147862,138,143,5,53,1,0,340,57.94117647058823,29.20792079207921
35148155,90,200,6,59,9,1,365,45.205479452054796,27.27272727272727
35148167,37,64,2,18,0,0,121,47.107438016528924,23.809523809523814
35148337,94,47,2,18,0,0,161,70.80745341614907,29.850746268656714
35148573,215,136,13,64,2,1,431,68.44547563805105,37.03703703703704
35148581,396,237,11,90,2,1,737,67.84260515603799,30.49853372434017
35148593,234,118,6,44,1,3,406,70.93596059113301,31.3953488372093
35148623,168,89,11,52,1,1,322,72.36024844720497,42.2077922077922
35148659,821,317,28,209,3,2,1380,77.02898550724638,43.291592128801426
35148702,99,45,8,17,2,0,171,73.6842105263158,37.5
35148714,437,185,21,148,4,2,797,76.78795483061481,48.611111111111114
35148994,174,123,12,50,2,0,361,65.92797783933517,34.224598930481285
35149081,69,14,4,18,0,0,105,86.66666666666667,61.111111111111114
35149100,439,162,17,81,0,4,703,76.95590327169275,38.63636363636363
35149135,178,68,6,21,1,0,274,75.18248175182481,29.166666666666664
35149330,208,127,8,42,5,0,390,67.435897435897445,30.219780219780223
35150061,110,112,1,26,13,4,266,57.89473684210527,28.205128205128204
35150265,471,444,17,74,2,1,1009,55.99603567888999,17.472118959107807
35150290,52,200,8,34,0,0,294,31.97278911564626,17.355371900826444
35150502,106,44,4,19,0,0,173,74.56647398843931,34.32835820895522
35150733,25,82,5,11,0,0,123,33.333333333333336,16.326530612244895
35150885,123,200,0,1,1,0,325,38.46153846153846,0.990099009900991
35150897,53,34,7,11,0,0,105,67.61904761904762,34.61538461538461
35151191,31,264,0,2,4,0,301,12.292358803986714,2.2222222222222254
35151348,17,233,0,11,7,1,269,13.382899628252787,7.539682539682535
35151373,77,49,0,9,0,0,135,63.70370370370371,15.517241379310342
35151385,343,350,11,39,10,1,754,53.580901856763916,14.841849148418495
35151476,452,325,7,13,1,0,798,59.27318295739348,6.069364161849711
35151497,117,337,8,48,0,0,510,33.92156862745098,14.249363867684483
35151506,185,1181,10,22,0,0,1398,15.52217453505007,2.638087386644683
35151518,196,574,11,52,4,2,839,31.585220500595945,10.730948678071538
35151609,1,72,2,0,0,0,75,4.0000000000000036,2.7027027027026973
35151610,49,2,0,1,1,0,53,96.22641509433963,50
35151671,4,43,0,0,3,0,50,14.000000000000002,6.521739130434778
35151701,56,358,5,15,0,0,434,17.511520737327192,5.291005291005291
35151725,116,324,8,62,1,0,511,36.594911937377695,17.974683544303794
35151737,246,114,13,48,1,0,422,72.98578199052133,35.22727272727273
35151749,59,164,3,31,1,0,258,36.434108527131784,17.587939698492463
35151804,17,33,10,23,1,0,84,60.71428571428572,50.74626865671642
35151841,86,161,5,330,0,0,582,72.33676975945016,67.54032258064517
35151889,220,342,10,84,2,0,658,48.02431610942249,21.91780821917808
35151956,11,28,0,6,0,0,45,37.77777777777778,17.647058823529417
35151968,36,180,1,25,2,0,244,26.22950819672131,13.461538461538458
35152336,19,77,2,7,2,0,107,28.037383177570096,12.5
35152500,47,101,0,4,3,0,155,34.83870967741935,6.481481481481477
35152511,96,269,7,29,5,3,409,34.229828850855746,14.057507987220452
35152523,254,163,1,33,1,0,452,63.938053097345126,17.67676767676768
35152614,39,52,2,11,0,0,104,50,19.999999999999996
35152742,96,107,0,1,0,0,204,47.549019607843135,0.92592592592593
35153060,135,74,1,10,2,0,222,66.66666666666667,14.942528735632187
35153084,416,216,3,62,1,0,698,69.05444126074498,23.404255319148938
35153096,123,115,4,19,0,0,261,55.93869731800767,16.666666666666664
35153114,258,153,4,25,1,1,442,65.38461538461539,16.84782608695652
35153285,216,331,0,15,1,0,563,41.207815275310836,4.610951008645536
35153497,247,110,5,38,1,0,401,72.56857855361596,28.57142857142857
35153503,142,132,3,25,0,0,302,56.29139072847682,17.500000000000004
35153527,43,59,1,15,0,0,118,50,21.333333333333336
35153564,114,192,12,29,5,0,352,45.45454545454546,19.327731092436974
35153597,32,50,2,8,0,0,92,45.652173913043484,16.666666666666664
35153606,13,29,0,3,0,0,45,35.55555555555555,9.375
35153624,30,53,2,20,2,0,107,50.46728971962617,31.16883116883117
35153631,184,412,3,17,2,0,618,33.333333333333336,5.0691244239631335
35153692,140,337,4,15,18,0,514,34.43579766536965,9.89304812834224
35153709,168,38,3,14,0,0,223,82.95964125560538,30.909090909090907
35153825,224,682,10,108,2,1,1027,33.59298928919182,15.068493150684937
35153837,541,33,1,16,0,1,592,94.42567567567568,35.29411764705882
35153904,4,92,3,18,3,0,120,23.33333333333333,20.68965517241379
35153989,544,940,5,32,17,0,1538,38.881664499349796,5.432595573440646
35153990,28,74,5,8,1,0,116,36.206896551724135,15.909090909090907
35154088,48,112,3,11,0,0,174,35.63218390804598,11.111111111111116
35154097,65,128,4,10,6,0,213,39.906103286384976,13.513513513513509
35154106,426,498,18,63,11,0,1016,50.98425196850393,15.593220338983048
35154155,13,49,2,6,1,0,71,30.98591549295775,15.517241379310342
35154179,50,138,1,9,2,0,200,31.000000000000007,7.9999999999999964
35154210,137,746,37,2,4,0,926,19.43844492440605,5.449936628643847
35154337,55,272,6,24,1,0,358,24.022346368715088,10.231023102310232
35154349,12,32,1,10,0,0,55,41.81818181818182,25.581395348837212
35154441,291,376,15,59,2,1,744,49.46236559139785,16.997792494481235
35154684,106,168,18,47,0,0,339,50.442477876106196,27.896995708154503
35154702,276,282,8,10,6,0,582,51.546391752577314,7.843137254901967
35154817,103,354,19,33,2,0,511,30.72407045009785,13.235294117647056
35154854,33,206,6,11,0,0,256,19.53125,7.623318385650224
35154945,48,157,3,1,4,0,213,26.291079812206576,4.848484848484846
35155019,228,435,6,42,2,2,715,39.16083916083915,10.677618069815198
35155068,11,42,0,5,0,0,58,27.586206896551722,10.63829787234043
35155073,48,175,6,16,24,0,269,34.94423791821561,20.814479638009054
35155251,48,155,6,21,2,1,233,33.47639484978541,16.216216216216218
35155263,69,207,8,21,13,0,318,34.905660377358494,16.867469879518072
35155287,244,409,27,194,6,1,881,53.575482406356414,35.79277864992151
35155299,251,81,8,57,1,1,399,79.69924812030075,45.270270270270274
35155706,15,28,0,0,0,0,43,34.883720930232556,0
35156231,751,295,4,46,26,2,1124,73.75444839857651,20.91152815013405
35156310,11,37,1,6,4,0,59,37.28813559322034,22.916666666666664
35156371,1,124,0,1,2,0,128,3.125,2.3622047244094446
35156383,0,41,0,0,0,0,41,0,0
35156401,53,181,1,2,0,0,237,23.628691983122362,1.6304347826086918
35156413,53,7,0,0,0,0,60,88.33333333333333,0
35156437,0,44,0,1,0,0,45,2.2222222222222254,2.2222222222222254
35156498,62,294,10,32,2,0,400,26.5,13.017751479289942
35156516,26,96,0,6,16,0,144,33.333333333333336,18.644067796610166
35156541,115,162,4,22,1,0,304,46.710526315789465,14.28571428571429
35156553,262,214,10,58,2,0,546,60.80586080586081,24.647887323943664
35156565,357,544,18,85,5,2,1011,46.19188921859545,16.81957186544343
35156735,11,30,6,11,1,0,59,49.152542372881356,37.5
35156747,5,45,0,3,0,0,53,15.094339622641506,6.25
35156760,49,2,0,0,0,0,51,96.07843137254902,0
35156772,18,35,0,3,0,0,56,37.5,7.8947368421052655
35156784,10,69,0,4,2,0,85,18.823529411764707,7.9999999999999964
35156796,57,7,1,0,0,0,65,89.23076923076923,12.5
35156905,57,80,4,12,1,0,154,48.05194805194806,17.525773195876294
35156954,78,560,4,6,7,0,655,14.503816793893131,2.9462738301559765
35157016,61,285,6,10,2,0,364,21.703296703296704,5.940594059405946
35157028,116,304,0,12,7,0,439,30.751708428246015,5.882352941176472
35157036,36,199,1,4,5,0,245,18.775510204081634,4.784688995215314
35157053,46,158,7,3,3,0,217,27.188940092165904,7.602339181286554
35157089,29,223,0,15,3,0,270,17.407407407407405,7.468879668049788
35157132,230,129,2,21,1,2,385,66.49350649350649,16.774193548387096
35157156,22,46,0,3,0,0,71,35.2112676056338,6.122448979591832
35157173,8,79,0,2,0,0,89,11.23595505617978,2.4691358024691357
35157223,4,70,0,0,0,0,74,5.405405405405405,0
35157247,167,100,4,25,2,0,298,66.44295302013423,23.664122137404576
35157338,20,34,0,2,2,0,58,41.379310344827594,10.526315789473683
35157375,0,47,1,0,1,0,49,4.081632653061229,4.081632653061229
35157405,60,84,4,12,2,0,162,48.14814814814815,17.647058823529417
35157442,65,45,1,7,1,0,119,62.18487394957983,16.666666666666664
35157478,129,295,17,49,0,1,491,39.91853360488798,18.508287292817684
35157685,21,60,1,17,0,0,99,39.39393939393939,23.076923076923073
35157715,4,78,4,4,0,0,90,13.33333333333333,9.302325581395355
35157739,8,38,4,6,0,0,56,32.14285714285714,20.833333333333336
35157764,34,16,0,1,0,0,51,68.62745098039215,5.882352941176472
35157788,25,24,0,3,0,0,52,53.84615384615385,11.111111111111116
35157806,146,22,5,16,0,0,189,88.35978835978835,48.837209302325576
35158197,61,252,5,34,1,0,353,28.611898016997173,13.698630136986301
35158264,4,61,0,8,6,0,79,22.78481012658228,18.666666666666664
35158276,4,146,1,2,2,0,155,5.8064516129032295,3.31125827814569
35158318,84,207,11,25,1,1,329,37.08206686930091,15.51020408163265
35158324,2,38,0,3,0,0,43,11.627906976744185,7.317073170731703
35158483,24,185,0,6,3,0,218,15.13761467889908,4.639175257731953
35158525,155,324,13,90,5,1,588,44.89795918367348,25.17321016166282
35158537,30,22,0,9,0,0,61,63.934426229508205,29.032258064516125
35158549,356,167,6,87,1,1,618,72.97734627831716,36.25954198473282
35158550,22,80,4,32,0,0,138,42.028985507246375,31.034482758620683
35158562,23,76,1,19,3,0,122,37.704918032786885,23.23232323232324
35158811,165,274,0,1,0,0,440,37.727272727272734,0.363636363636366
35158823,30,599,1,16,24,0,670,10.597014925373138,6.406250000000002
35158872,170,132,4,27,0,0,333,60.36036036036037,19.018404907975462
35158926,15,24,3,4,0,0,46,47.82608695652174,22.580645161290324
35158938,63,100,1,10,1,0,175,42.85714285714286,10.71428571428571
35158951,243,49,10,44,0,0,346,85.83815028901734,52.42718446601942
35159268,38,150,2,10,1,0,201,25.373134328358205,7.975460122699385
35159273,51,81,1,21,0,0,154,47.4025974025974,21.359223300970875
35159281,53,142,6,29,2,0,232,38.793103448275865,20.67039106145251
35160763,147,242,22,72,1,0,484,50,28.189910979228483
35161007,66,186,8,16,1,0,277,32.851985559566785,11.848341232227488
35161238,100,314,10,18,1,0,443,29.119638826185103,8.45481049562682
35161287,288,221,11,46,1,0,567,61.02292768959436,20.78853046594982
35161299,131,371,9,88,0,1,600,38.16666666666667,20.895522388059707
35161317,131,228,4,60,0,0,423,46.09929078014184,21.91780821917808
35161412,77,197,12,29,13,0,328,39.9390243902439,21.513944223107572
35161561,14,126,1,2,6,0,149,15.436241610738255,6.666666666666665
35161585,13,26,1,4,1,0,45,42.22222222222223,18.75
35161718,105,234,0,14,0,1,354,33.89830508474576,6.024096385542165
35161724,52,99,4,10,0,0,165,40,12.389380530973447
35161780,37,241,3,11,0,0,292,17.46575342465754,5.490196078431375
35161937,317,103,2,0,2,0,424,75.70754716981132,3.738317757009346
35161949,81,146,7,41,0,0,275,46.909090909090914,24.742268041237114
35162152,74,106,4,23,0,0,207,48.79227053140096,20.300751879699252
35162197,4,39,0,1,0,0,44,11.363636363636365,2.500000000000002
35162243,294,1678,0,17,21,0,2010,16.517412935323385,2.2144522144522116
35162280,42,176,6,14,3,0,241,26.970954356846477,11.557788944723612
35162334,42,90,5,49,1,0,187,51.871657754010705,37.93103448275862
35162358,37,119,4,29,2,0,191,37.69633507853403,22.72727272727273
35162371,1,86,0,1,0,0,88,2.2727272727272707,1.1494252873563204
35162425,58,164,3,26,0,0,251,34.66135458167331,15.025906735751294
35162474,12,46,0,0,1,0,59,22.033898305084744,2.127659574468088
35162498,45,275,8,22,3,0,353,22.09631728045326,10.71428571428571
35162553,2,65,0,2,0,0,69,5.797101449275366,2.985074626865669
35162577,3,114,1,6,3,0,127,10.236220472440948,8.064516129032262
35162589,1,71,0,5,0,0,77,7.792207792207795,6.578947368421051
35162619,1,41,0,0,0,0,42,2.3809523809523836,0
35162632,11,30,0,9,0,0,50,40,23.076923076923073
35162656,15,52,3,10,0,0,80,35,19.999999999999996
35162723,121,5,0,0,1,0,127,96.06299212598425,16.666666666666664
35162735,5,65,4,0,16,0,90,27.77777777777778,23.529411764705888
35162760,0,164,0,0,0,0,164,0,0
35162772,0,61,0,0,0,0,61,0,0
35162796,6,49,0,6,5,0,66,25.757575757575758,18.333333333333336
35162826,79,63,7,26,2,1,178,64.60674157303372,36.36363636363637
35162848,52,44,0,6,1,0,103,57.28155339805825,13.725490196078427
35162851,23,37,0,2,0,0,62,40.32258064516129,5.128205128205132
35162917,17,105,4,10,0,0,136,22.79411764705882,11.764705882352944
35162930,154,326,13,65,0,0,558,41.577060931899645,19.3069306930693
35162966,114,310,5,10,0,0,439,29.384965831435082,4.61538461538461
35162978,181,268,1,5,1,1,457,41.35667396061269,2.898550724637683
35163016,66,160,1,2,3,0,232,31.034482758620683,3.6144578313253017
35163028,40,80,2,3,0,0,125,36,5.882352941176472
35163041,6,41,2,0,0,0,49,16.326530612244895,4.651162790697672
35163077,33,15,0,0,0,0,48,68.75,0
35163120,16,64,0,4,0,0,84,23.809523809523814,5.882352941176472
35163132,3,105,0,2,0,0,110,4.545454545454541,1.869158878504673
35163168,12,81,1,14,1,0,109,25.688073394495415,16.49484536082474
35163181,62,53,4,14,0,0,133,60.150375939849624,25.352112676056336
35163259,150,137,1,21,0,1,310,55.80645161290323,14.375000000000004
35163272,76,255,2,29,0,0,362,29.558011049723753,10.839160839160844
35163326,350,624,16,102,8,1,1101,43.324250681198905,16.91078561917443
35163338,808,404,13,77,3,2,1307,69.08951798010712,19.038076152304605
35163399,13,46,0,7,0,0,66,30.303030303030297,13.207547169811317
35163430,48,137,10,12,0,0,207,33.81642512077294,13.83647798742138
35163442,25,84,1,6,0,0,116,27.586206896551722,7.692307692307687
35163512,16,207,0,1,1,0,225,7.9999999999999964,0.9569377990430672
35163533,3,39,2,7,0,0,51,23.529411764705888,18.75
35163806,39,244,2,17,1,0,303,19.471947194719476,7.57575757575758
35163867,1,73,0,2,2,0,78,6.41025641025641,5.1948051948051965
35163880,4,46,2,0,0,0,52,11.538461538461542,4.1666666666666625
35164070,3,68,0,1,0,0,72,5.555555555555558,1.449275362318836
35164082,75,283,1,3,3,0,365,22.46575342465753,2.4137931034482807
35164094,0,43,0,0,0,0,43,0,0
35164100,72,180,3,24,4,0,283,36.39575971731449,14.691943127962082
35164136,2,176,0,0,0,0,178,1.1235955056179803,0
35164159,7,116,3,8,2,0,136,14.70588235294118,10.077519379844958
35164197,23,53,2,4,2,0,84,36.904761904761905,13.11475409836066
35164422,11,54,0,4,0,0,69,21.739130434782606,6.896551724137934
35164458,140,133,4,29,2,0,308,56.81818181818181,20.833333333333336
35164513,9,72,0,10,1,0,92,21.739130434782606,13.253012048192769
35164525,14,93,6,9,3,0,125,25.6,16.216216216216218
35164537,2,115,0,1,4,0,122,5.737704918032782,4.1666666666666625
35164586,47,49,0,0,1,0,97,49.48453608247423,2.0000000000000018
35164598,3,53,1,0,0,0,57,7.017543859649122,1.851851851851849
35164604,4,103,5,4,1,0,117,11.965811965811968,8.849557522123897
35164616,49,52,5,6,1,0,113,53.98230088495575,18.75
35164636,122,33,1,4,1,0,161,79.5031055900621,15.384615384615385
35164732,76,60,3,17,1,0,157,61.78343949044586,25.92592592592593
35165098,93,217,8,70,0,0,388,44.072164948453604,26.4406779661017
35165104,51,349,11,34,1,0,446,21.748878923766814,11.64556962025316
35165207,128,138,1,32,0,2,301,54.15282392026578,20.231213872832367
35165220,161,107,1,19,0,0,288,62.84722222222222,15.748031496062998
35165232,390,467,15,115,0,0,987,52.68490374873353,21.775544388609713
35165244,77,146,1,38,0,0,262,44.27480916030534,21.081081081081077
35165300,59,182,5,17,0,0,263,30.798479087452467,10.784313725490192
35165311,162,378,6,3,27,3,579,34.715025906735754,9.352517985611508
35165323,194,367,1,13,6,0,581,36.83304647160068,5.167958656330751
35165335,15,49,0,4,1,0,69,28.985507246376805,9.259259259259256
35165347,240,228,1,1,3,0,473,51.79704016913319,2.145922746781115
35165359,460,186,4,16,3,1,670,72.23880597014926,11.428571428571432
35165372,131,97,6,61,1,0,296,67.22972972972974,41.21212121212121
35165591,840,679,60,330,11,6,1926,64.74558670820353,37.476979742173114
35165612,23,78,1,9,3,0,114,31.57894736842105,14.28571428571429
35165621,177,333,16,99,2,1,628,46.974522292993626,26.164079822616404
35165633,77,43,1,14,0,0,135,68.14814814814815,25.86206896551724
35165670,377,610,31,46,3,1,1068,42.88389513108615,11.722141823444288
35165700,49,172,2,8,1,0,232,25.86206896551724,6.010928961748629
35165748,205,108,4,38,0,0,355,69.57746478873239,28.000000000000004
35167411,124,426,11,50,0,0,611,30.27823240589198,12.525667351129366
35167435,98,68,8,18,0,0,192,64.58333333333333,27.6595744680851
35167447,222,531,10,40,4,0,807,34.20074349442379,9.230769230769232
35167459,132,193,12,63,3,0,403,52.10918114143921,28.782287822878228
35167472,14,29,1,1,0,0,45,35.55555555555555,6.451612903225811
35167782,57,332,9,64,0,0,462,28.13852813852814,18.02469135802469
35168661,67,174,3,21,2,0,267,34.8314606741573,13
35168671,350,515,17,177,6,1,1066,51.688555347091935,28.07262569832403
35168683,109,172,3,18,2,0,304,43.42105263157895,11.794871794871797
35168701,158,106,13,62,1,0,340,68.82352941176471,41.75824175824175
35168762,71,214,1,23,0,0,309,30.74433656957929,10.084033613445376
35168828,157,305,6,39,5,0,512,40.4296875,14.084507042253524
35168841,60,115,5,24,0,0,204,43.627450980392155,20.138888888888886
35168853,199,443,6,26,1,0,675,34.370370370370374,6.932773109243695
35169055,6,76,0,1,1,0,84,9.523809523809524,2.564102564102566
35169067,51,95,1,20,2,0,169,43.786982248520715,19.491525423728817
35169663,45,67,3,9,0,0,124,45.96774193548387,15.189873417721522
35170550,47,68,2,12,0,0,129,47.28682170542635,17.07317073170732
35170636,259,158,12,61,0,1,491,67.82077393075356,31.896551724137932
35170677,2,91,0,1,1,0,95,4.210526315789476,2.1505376344086002
35170707,279,45,0,0,0,0,324,86.11111111111111,0
35170719,12,77,2,1,2,0,94,18.085106382978722,6.0975609756097615
35170732,136,347,1,2,2,0,488,28.893442622950815,1.4204545454545414
35170768,145,142,0,1,0,0,288,50.69444444444444,0.6993006993006978
35170793,2,50,0,1,1,0,54,7.4074074074074066,3.8461538461538436
35170859,49,4,0,0,1,0,54,92.5925925925926,19.999999999999996
35170896,14,39,1,4,0,0,58,32.758620689655174,11.363636363636365
35170938,7,81,1,1,0,0,90,9.999999999999998,2.409638554216864
35170951,5,40,0,5,0,0,50,19.999999999999996,11.111111111111116
35170975,89,285,10,49,1,0,434,34.331797235023046,17.391304347826086
35170987,24,36,0,3,0,0,63,42.85714285714286,7.692307692307687
35171001,363,29,2,21,0,0,415,93.01204819277108,44.230769230769226
35171074,3,164,0,11,2,0,180,8.888888888888891,7.344632768361581
35171098,6,78,2,7,2,0,95,17.894736842105264,12.35955056179775
35171116,97,197,4,4,0,0,302,34.7682119205298,3.9024390243902474
35171189,108,542,12,39,7,0,708,23.44632768361582,9.666666666666668
35171190,9,42,2,2,0,0,55,23.636363636363633,8.695652173913048
35171207,20,287,4,4,5,0,320,10.312500000000002,4.333333333333334
35171256,46,21,1,2,0,0,70,70,12.5
35171268,7,62,1,9,0,0,79,21.518987341772156,13.888888888888884
35171273,4,218,1,4,1,0,228,4.385964912280704,2.67857142857143
35171311,56,263,10,28,2,0,359,26.740947075208908,13.201320132013205
35171335,57,29,0,0,0,0,86,66.27906976744187,0
35171360,110,302,11,31,2,2,458,34.06113537117904,13.218390804597702
35171384,1,51,0,25,8,0,85,40,39.28571428571429
35171396,15,30,1,30,0,0,76,60.526315789473685,50.81967213114754
35171414,22,18,1,2,2,0,45,60,21.739130434782606
35171448,92,69,5,8,1,0,175,60.57142857142856,16.867469879518072
35171487,93,357,8,52,2,0,512,30.2734375,14.797136038186153
35171542,5,50,0,4,4,0,63,20.63492063492064,13.793103448275868
35171621,1,55,0,1,10,0,67,17.910447761194025,16.666666666666664
35171700,28,119,5,8,0,0,160,25.624999999999996,9.848484848484851
35171748,27,96,1,20,5,0,149,35.570469798657726,21.311475409836067
35171773,0,70,0,2,6,0,78,10.256410256410254,10.256410256410254
35171785,9,139,1,4,5,0,158,12.0253164556962,6.711409395973156
35172492,369,398,29,279,2,1,1078,63.07977736549165,43.86459802538787
35172509,360,228,8,69,3,1,669,65.91928251121077,26.21359223300971
35172546,100,102,1,15,0,0,218,53.21100917431192,13.559322033898303
35172558,99,149,8,34,0,0,290,48.62068965517241,21.98952879581152
35173149,25,68,0,7,0,0,100,31.999999999999996,9.333333333333337
35173150,32,125,19,29,3,0,208,39.90384615384615,28.97727272727273
35173174,420,828,30,188,5,0,1471,43.711760707002036,21.21788772597526
35173319,15,70,1,10,0,0,96,27.083333333333336,13.580246913580252
35173685,64,258,2,14,0,1,339,23.893805309734518,6.181818181818177
35173708,331,565,20,73,3,1,993,43.10171198388721,14.65256797583081
35173712,1272,844,13,202,2,1,2334,63.83890317052271,20.527306967984938
35174087,320,185,4,20,7,0,536,65.48507462686567,14.35185185185185
35174099,52,158,3,59,2,1,275,42.54545454545454,29.147982062780265
35174166,21,105,6,19,0,0,151,30.4635761589404,19.23076923076923
35174178,13,90,4,7,0,0,114,21.052631578947366,10.89108910891089
35174185,27,31,1,2,0,0,61,49.18032786885246,8.823529411764708
35174208,160,131,1,14,0,0,306,57.18954248366013,10.273972602739722
35174212,23,51,2,12,0,1,89,42.69662921348315,22.72727272727273
35174336,65,238,5,7,2,0,317,24.9211356466877,5.555555555555558
35175043,82,203,3,20,2,0,310,34.51612903225807,10.964912280701755
35175547,8,60,0,1,0,0,69,13.043478260869568,1.6393442622950838
35175870,56,86,7,16,2,0,167,48.50299401197605,22.522522522522525
35175900,90,50,5,10,0,0,155,67.74193548387098,23.076923076923073
35175936,373,790,20,82,2,3,1270,37.79527559055118,11.928651059085837
35175959,54,357,7,15,1,0,434,17.741935483870964,6.052631578947365
35175961,306,483,19,94,3,0,905,46.629834254143645,19.36560934891486
35176151,41,49,0,10,0,0,100,51,16.94915254237288
35176163,7,45,0,1,0,0,53,15.094339622641506,2.1739130434782594
35176205,165,141,2,10,6,0,324,56.48148148148149,11.32075471698113
35176576,422,88,0,4,0,0,514,82.8793774319066,4.347826086956519
35176588,713,349,26,101,9,0,1198,70.86811352253757,28.04123711340206
35176597,398,154,8,72,1,0,633,75.67140600315956,34.468085106382986
35176667,18,24,0,7,0,0,49,51.02040816326531,22.580645161290324
35176679,54,84,0,15,0,0,153,45.09803921568627,15.151515151515149
35176795,3,61,0,0,0,0,64,4.6875,0
35176837,30,38,7,15,0,0,90,57.77777777777777,36.66666666666667
35176850,5,53,3,1,0,0,62,14.516129032258062,7.017543859649122
35176862,19,30,1,18,1,0,69,56.52173913043479,40
35176904,65,8,0,2,0,0,75,89.33333333333333,19.999999999999996
35176916,36,56,2,10,0,0,104,46.15384615384615,17.647058823529417
35176936,5,51,2,17,0,0,75,31.999999999999996,27.142857142857146
35176965,120,78,9,83,0,0,290,73.10344827586206,54.117647058823536
35176977,96,26,2,28,0,0,152,82.89473684210526,53.57142857142857
35176989,101,192,13,69,1,0,376,48.93617021276596,30.181818181818176
35177015,147,186,9,82,0,0,424,56.132075471698116,32.851985559566785
35177027,44,94,3,38,0,0,179,47.486033519553075,30.37037037037037
35177076,72,164,4,54,0,1,295,44.40677966101695,26.45739910313901
35177106,39,84,5,33,0,1,162,48.14814814814815,31.707317073170728
35177143,53,116,12,31,1,0,213,45.539906103286384,27.500000000000004
35177155,28,57,6,73,1,0,165,65.45454545454545,58.3941605839416
35177179,173,166,22,57,2,2,422,60.66350710900474,33.333333333333336
35177180,89,122,4,21,1,0,237,48.52320675105485,17.567567567567565
35177192,120,81,0,15,0,0,216,62.5,15.625
35177210,74,131,15,57,1,1,279,53.04659498207885,36.09756097560975
35177234,4,51,0,0,0,0,55,7.272727272727275,0
35177258,36,93,3,10,0,0,142,34.50704225352113,12.264150943396224
35177398,81,197,4,8,2,0,292,32.534246575342465,6.635071090047395
35177416,74,163,2,6,1,0,246,33.739837398373986,5.232558139534882
35177441,38,20,0,34,0,0,92,78.26086956521739,62.96296296296296
35177489,6,96,0,1,0,0,103,6.796116504854366,1.0309278350515427
35177519,97,22,0,0,1,0,120,81.66666666666667,4.347826086956519
35177532,47,52,0,6,0,0,105,50.476190476190474,10.344827586206895
35177556,45,134,5,22,0,0,206,34.95145631067961,16.770186335403725
35177593,1,55,0,1,0,0,57,3.508771929824561,1.7857142857142905
35177726,6,68,0,1,0,0,75,9.333333333333337,1.449275362318836
35177799,2,65,0,1,0,0,68,4.411764705882348,1.5151515151515138
35177830,1,80,0,1,1,0,83,3.6144578313253017,2.4390243902439046
35177854,4,71,0,0,0,0,75,5.333333333333334,0
35177921,37,56,1,2,0,0,96,41.666666666666664,5.0847457627118615
35177933,2,72,0,0,0,0,74,2.7027027027026973,0
35177957,63,34,0,2,1,0,100,65.99999999999999,8.108108108108103
35178019,6,139,1,7,0,0,153,9.150326797385622,5.442176870748295
35178020,73,340,0,11,40,0,464,26.724137931034488,13.043478260869568
35178056,84,4,1,1,0,0,90,95.55555555555556,33.333333333333336
35178100,9,42,5,14,7,0,77,45.45454545454546,38.23529411764706
35178159,60,6,0,0,0,0,66,90.9090909090909,0
35178160,77,321,5,34,0,0,437,26.544622425629292,10.833333333333329
35178184,6,51,0,9,1,0,67,23.880597014925375,16.393442622950815
35178299,141,223,7,33,0,1,405,44.93827160493827,15.530303030303028
35178354,3,53,0,0,0,0,56,5.35714285714286,0
35178366,39,36,0,1,0,0,76,52.63157894736843,2.7027027027026973
35178385,41,63,0,2,0,0,106,40.56603773584906,3.076923076923077
35178457,40,27,0,1,1,0,69,60.86956521739131,6.896551724137934
35178469,13,36,0,11,2,0,62,41.93548387096774,26.530612244897956
35178559,4,35,0,4,1,0,44,20.45454545454546,12.5
35179000,113,29,0,4,1,0,147,80.27210884353741,14.70588235294118
35179848,145,212,7,71,0,0,435,51.26436781609196,26.89655172413793
35179887,59,84,4,12,2,0,161,47.82608695652174,17.647058823529417
35180002,71,27,0,16,0,2,116,76.72413793103449,40
35180026,44,22,8,20,0,0,94,76.59574468085107,56.00000000000001
35180038,137,40,1,21,0,1,200,80,36.50793650793651
35180048,17,63,7,71,4,0,162,61.111111111111114,56.55172413793104
35180063,88,6,2,2,0,0,98,93.87755102040816,40
35180075,126,36,7,29,2,2,202,82.17821782178218,52.63157894736843
35180087,68,35,5,16,2,2,128,72.65625,41.666666666666664
35180099,24,18,1,7,0,0,50,64,30.76923076923077
35180117,29,27,9,91,1,2,159,83.01886792452831,79.23076923076923
35180142,48,18,0,3,0,0,69,73.91304347826086,14.28571428571429
35180166,69,34,2,9,1,0,115,70.43478260869564,26.086956521739136
35180178,68,67,1,32,2,0,170,60.58823529411765,34.31372549019608
35180185,166,31,0,12,1,0,210,85.23809523809524,29.54545454545454
35180191,89,15,7,6,1,0,118,87.28813559322035,48.275862068965516
35180208,44,18,0,3,1,0,66,72.72727272727273,18.181818181818176
35180221,96,79,0,5,3,0,183,56.830601092896174,9.195402298850574
35180245,37,9,8,15,1,0,70,87.14285714285714,72.72727272727273
35180269,73,71,3,28,0,0,175,59.42857142857143,30.3921568627451
35180270,52,32,1,15,1,0,101,68.31683168316832,34.693877551020414
35180282,84,23,2,22,0,0,131,82.44274809160305,51.06382978723405
35180294,47,31,1,25,0,0,104,70.1923076923077,45.614035087719294
35180300,87,49,6,22,1,0,165,70.3030303030303,37.17948717948718
35180312,17,36,2,15,0,0,70,48.57142857142858,32.07547169811321
35180336,197,43,1,53,0,0,294,85.37414965986395,55.670103092783506
35180361,74,19,0,7,0,0,100,81,26.923076923076927
35180373,6,135,11,72,0,0,224,39.73214285714286,38.07339449541285
35180385,90,12,6,11,1,0,120,90,60
35180397,97,28,1,8,0,0,134,79.10447761194031,24.32432432432432
35180415,129,16,3,4,0,0,152,89.47368421052632,30.434782608695656
35180427,72,38,0,20,1,0,131,70.99236641221374,35.59322033898306
35180439,91,14,1,13,1,0,120,88.33333333333333,51.72413793103448
35180452,139,62,6,32,0,0,239,74.05857740585773,38
35180464,32,19,2,7,0,0,60,68.33333333333333,32.14285714285714
35180488,87,56,2,20,3,0,168,66.66666666666667,30.864197530864203
35180524,34,43,5,34,2,0,118,63.55932203389831,48.80952380952381
35180543,66,12,1,25,0,1,105,88.57142857142857,69.23076923076923
35180555,65,10,1,20,1,1,98,89.79591836734694,69.6969696969697
35180567,16,58,8,94,2,0,178,67.41573033707866,64.19753086419753
35180580,111,13,0,9,0,0,133,90.22556390977444,40.90909090909091
35180592,103,50,3,30,1,0,187,73.2620320855615,40.476190476190474
35180610,51,11,1,3,0,0,66,83.33333333333334,26.66666666666667
35180622,116,15,0,7,2,0,140,89.28571428571429,37.5
35180634,19,36,2,10,0,1,68,47.05882352941176,26.530612244897956
35180658,40,19,2,13,0,0,74,74.32432432432432,44.11764705882353
35180661,41,20,5,13,0,0,79,74.68354430379746,47.36842105263158
35180701,13,43,4,48,0,0,108,60.18518518518518,54.73684210526315
35180713,55,51,3,30,1,0,140,63.57142857142857,40
35180750,155,52,3,65,0,0,275,81.0909090909091,56.666666666666664
35180774,67,59,10,71,1,0,208,71.63461538461539,58.156028368794324
35180798,98,20,4,13,0,0,135,85.18518518518519,45.945945945945944
35180804,61,40,8,21,0,0,130,69.23076923076923,42.028985507246375
35180816,33,30,0,34,0,0,97,69.0721649484536,53.125
35180828,22,53,2,17,2,0,96,44.791666666666664,28.37837837837838
35180853,18,190,4,49,4,0,265,28.301886792452834,23.076923076923073
35180865,99,39,6,23,0,0,167,76.64670658682635,42.64705882352941
35180877,30,50,9,36,0,0,125,60,47.36842105263158
35180890,77,62,9,22,4,2,176,64.77272727272727,37.37373737373737
35180919,80,25,16,22,0,0,143,82.51748251748252,60.31746031746032
35180920,0,71,10,18,0,0,99,28.282828282828287,28.282828282828287
35180944,48,66,3,62,0,0,179,63.12849162011174,49.61832061068703
35180956,70,90,12,52,5,0,229,60.698689956331876,43.39622641509434
35180973,30,81,7,30,1,0,149,45.63758389261745,31.932773109243694
35181006,91,30,10,16,1,0,148,79.72972972972973,47.36842105263158
35181024,73,102,5,25,2,0,207,50.72463768115942,23.880597014925375
35181031,127,29,5,18,0,0,179,83.79888268156425,44.230769230769226
35181055,47,43,3,16,2,0,111,61.261261261261254,32.8125
35181067,15,29,1,15,0,0,60,51.66666666666666,35.55555555555555
35181109,58,12,3,20,0,0,93,87.09677419354838,65.71428571428571
35181122,60,40,0,9,0,0,109,63.30275229357798,18.36734693877551
35181134,55,19,1,8,2,0,85,77.64705882352942,36.66666666666667
35181161,146,47,11,55,2,1,262,82.06106870229007,59.48275862068966
35181171,32,49,2,28,0,1,112,56.25,38.74999999999999
35181183,69,33,2,36,0,0,140,76.42857142857142,53.52112676056338
35181195,85,36,2,12,0,1,136,73.52941176470588,29.411764705882348
35181201,58,40,2,27,0,0,127,68.50393700787401,42.028985507246375
35181213,88,28,1,19,1,0,137,79.56204379562044,42.85714285714286
35181225,39,32,0,3,0,1,75,57.33333333333333,11.111111111111116
35181250,82,73,1,23,0,0,179,59.21787709497206,24.742268041237114
35181262,66,79,1,44,0,0,190,58.42105263157895,36.29032258064516
35181274,13,114,5,54,0,0,186,38.70967741935484,34.104046242774565
35181286,84,29,1,14,1,0,129,77.51937984496125,35.55555555555555
35181298,28,26,3,9,1,0,67,61.19402985074627,33.333333333333336
35181304,34,54,2,17,0,1,108,50,27.027027027027028
35181316,4,137,2,43,1,0,187,26.7379679144385,25.136612021857918
35181328,108,67,3,23,1,0,202,66.83168316831683,28.723404255319153
35181336,262,44,5,23,0,0,334,86.82634730538922,38.888888888888886
35181353,46,9,0,8,0,0,63,85.71428571428572,47.05882352941176
35181377,6,43,1,10,0,0,60,28.333333333333332,20.370370370370374
35181389,69,44,2,17,0,0,132,66.66666666666667,30.15873015873016
35181390,7,50,4,21,0,0,82,39.02439024390244,33.333333333333336
35181407,10,38,1,13,0,0,62,38.70967741935484,26.923076923076927
35181419,95,28,4,14,0,0,141,80.1418439716312,39.13043478260869
35181420,40,34,0,9,0,0,83,59.036144578313255,20.93023255813954
35181432,86,28,3,9,0,0,126,77.77777777777779,30.000000000000004
35181444,31,120,7,58,3,0,219,45.205479452054796,36.170212765957444
35181468,43,79,9,66,0,1,198,60.1010101010101,49.032258064516135
35181473,82,24,1,12,0,0,119,79.83193277310924,35.13513513513513
35181523,105,16,3,13,0,0,137,88.32116788321169,50
35181559,48,36,0,7,0,1,92,60.86956521739131,18.181818181818176
35181560,51,14,4,11,0,0,80,82.5,51.72413793103448
35181572,73,64,5,16,0,0,158,59.493670886075954,24.705882352941178
35181584,88,25,6,7,0,1,127,80.31496062992126,35.89743589743589
35181663,96,18,1,10,4,0,129,86.04651162790698,45.45454545454546
35181675,185,24,4,37,4,6,260,90.76923076923077,68
35181705,101,25,10,19,0,0,155,83.87096774193549,53.703703703703695
35181717,99,38,5,38,1,0,181,79.00552486187846,53.65853658536586
35181729,104,13,3,24,0,1,145,91.0344827586207,68.29268292682926
35181730,37,29,6,46,0,0,118,75.42372881355932,64.19753086419753
35181742,97,39,4,17,0,0,157,75.15923566878982,35
35181754,83,44,12,32,0,0,171,74.26900584795322,50
35181766,109,19,5,20,0,0,153,87.58169934640523,56.81818181818181
35181785,101,29,0,56,2,1,189,84.65608465608466,67.04545454545455
35181791,420,91,3,178,2,0,694,86.88760806916427,66.78832116788321
35181808,3,119,8,95,0,0,225,47.111111111111114,46.3963963963964
35181812,123,12,2,16,0,0,153,92.15686274509804,60
35181821,69,60,2,56,2,0,189,68.25396825396825,50
35181833,38,12,0,15,0,0,65,81.53846153846153,55.55555555555556
35181845,42,46,9,61,0,0,158,70.88607594936708,60.3448275862069
35181869,78,12,1,54,1,0,146,91.78082191780823,82.35294117647058
35181870,134,15,3,15,1,0,168,91.07142857142857,55.88235294117647
35181882,122,48,6,17,0,0,193,75.12953367875647,32.3943661971831
35181894,94,21,3,6,0,0,124,83.06451612903226,30.000000000000004
35181900,68,20,8,12,0,1,109,81.65137614678899,51.21951219512195
35181912,157,11,2,21,0,0,191,94.24083769633508,67.64705882352942
35181924,92,47,6,11,0,0,156,69.87179487179486,26.5625
35181936,72,29,8,36,0,0,145,80,60.273972602739725
35181961,110,30,0,13,0,0,153,80.3921568627451,30.23255813953488
35181973,74,42,6,22,0,0,144,70.83333333333333,40
35181985,48,21,0,11,0,0,80,73.75,34.375
35182000,186,111,5,55,1,1,359,69.08077994428969,35.83815028901734
35182011,22,56,7,45,0,0,130,56.92307692307692,48.14814814814815
35182023,45,12,0,13,0,0,70,82.85714285714285,52
35182035,90,61,4,67,0,0,222,72.52252252252251,53.78787878787878
35182047,120,25,2,12,1,0,160,84.375,37.5
35182059,57,19,3,27,0,0,106,82.0754716981132,61.224489795918366
35182060,97,43,6,32,0,0,178,75.84269662921348,46.913580246913575
35182096,66,45,1,20,2,0,134,66.4179104477612,33.82352941176471
35182114,509,36,4,41,1,0,591,93.90862944162437,56.09756097560976
35182138,132,26,13,22,0,0,193,86.52849740932642,57.377049180327866
35182148,265,40,2,25,0,1,333,87.98798798798799,41.17647058823529
35182151,149,21,2,25,1,0,198,89.39393939393939,57.14285714285714
35182163,398,64,4,21,0,1,488,86.88524590163934,28.888888888888886
35182175,84,23,3,9,0,0,119,80.67226890756302,34.285714285714285
35182205,150,33,7,19,0,0,209,84.21052631578947,44.067796610169495
35182217,71,19,0,32,1,0,123,84.55284552845528,63.46153846153846
35182229,82,54,6,19,0,0,161,66.45962732919256,31.645569620253166
35182242,98,25,2,7,0,0,132,81.06060606060606,26.470588235294112
35182291,33,15,0,9,1,2,60,75,44.44444444444444
35182308,47,40,1,11,0,0,99,59.5959595959596,23.076923076923073
35182312,28,89,3,26,1,0,147,39.455782312925166,25.210084033613445
35182321,80,65,1,19,0,0,165,60.60606060606061,23.529411764705888
35182357,105,28,1,56,1,1,192,85.41666666666666,67.81609195402298
35182370,25,48,3,28,1,0,105,54.28571428571429,40
35182382,8,36,2,26,3,4,79,54.43037974683544,49.29577464788733
35182394,147,69,3,19,1,0,239,71.1297071129707,25
35182400,90,65,3,34,0,0,192,66.14583333333333,36.274509803921575
35182424,163,47,9,15,1,1,236,80.08474576271186,35.61643835616438
35182448,36,85,1,15,2,0,139,38.84892086330935,17.47572815533981
35182459,52,27,0,0,1,0,80,66.25,3.57142857142857
35182485,71,42,5,30,2,1,151,72.18543046357617,47.5
35182497,96,47,4,8,0,0,155,69.6774193548387,20.33898305084746
35182503,66,16,1,13,0,2,98,83.6734693877551,50
35182515,21,55,6,30,0,0,112,50.89285714285714,39.56043956043956
35182527,42,78,2,36,0,0,158,50.63291139240506,32.758620689655174
35182539,32,38,2,15,1,3,91,58.241758241758234,35.59322033898306
35182552,158,36,5,29,0,7,235,84.68085106382979,53.24675324675325
35182564,14,17,4,33,0,0,68,75,68.5185185185185
35182576,39,62,7,72,2,0,182,65.93406593406593,56.64335664335665
35182588,66,105,4,42,1,2,220,52.27272727272727,31.818181818181824
35182597,109,69,4,51,2,1,236,70.76271186440678,45.669291338582674
35182606,73,40,4,22,0,0,139,71.22302158273382,39.39393939393939
35182618,79,40,7,48,1,0,175,77.14285714285715,58.33333333333333
35182624,55,19,4,19,0,1,98,80.61224489795919,55.81395348837209
35182631,31,74,12,41,0,0,158,53.16455696202531,41.73228346456693
35182643,91,28,5,36,0,0,160,82.5,59.42028985507246
35182655,135,18,0,26,0,0,179,89.94413407821229,59.09090909090908
35182667,66,44,5,29,0,0,144,69.44444444444444,43.58974358974359
35182679,47,30,3,41,0,0,121,75.20661157024793,59.45945945945945
35182680,67,23,0,25,0,0,115,80,52.08333333333333
35182692,55,18,10,27,0,0,110,83.63636363636364,67.27272727272727
35182709,54,20,1,20,0,0,95,78.94736842105263,51.21951219512195
35182710,63,32,1,42,1,0,139,76.97841726618705,57.89473684210527
35182722,64,26,5,43,0,0,138,81.15942028985508,64.86486486486487
35182734,76,24,4,17,0,0,121,80.16528925619835,46.666666666666664
35182746,160,79,5,26,0,2,272,70.95588235294117,29.464285714285708
35182758,109,55,3,25,1,0,193,71.50259067357513,34.523809523809526
35182761,97,21,3,17,2,0,140,85,51.162790697674424
35182771,9,66,11,45,0,0,131,49.61832061068703,45.90163934426229
35182783,44,68,5,17,2,0,136,50,26.086956521739136
35182795,79,30,5,15,0,0,129,76.74418604651163,40
35182825,46,59,5,42,0,0,152,61.184210526315795,44.339622641509436
35182837,53,29,3,17,1,0,103,71.84466019417476,42.00000000000001
35182849,10,123,13,62,0,1,209,41.14832535885168,38.19095477386934
35182850,21,65,7,44,2,1,140,53.57142857142857,45.378151260504204
35182862,88,33,3,38,0,0,162,79.62962962962963,55.4054054054054
35182874,67,41,3,29,0,0,140,70.71428571428571,43.83561643835616
35182916,62,38,3,20,0,0,123,69.10569105691057,37.704918032786885
35182936,87,33,4,33,0,1,158,79.11392405063292,53.52112676056338
35182953,15,89,11,95,0,1,211,57.81990521327014,54.59183673469388
35182965,71,38,2,28,0,0,139,72.66187050359711,44.11764705882353
35182989,79,34,6,31,0,0,150,77.33333333333333,52.112676056338024
35182990,131,40,1,15,0,0,187,78.6096256684492,28.57142857142857
35183003,25,70,9,43,0,0,147,52.38095238095239,42.622950819672134
35183015,65,43,4,14,6,0,132,67.42424242424244,35.820895522388064
35183027,129,27,3,24,0,0,183,85.24590163934427,50
35183039,91,65,5,50,0,1,212,69.33962264150944,46.28099173553719
35183040,47,53,7,39,1,0,147,63.94557823129252,47
35183064,28,65,3,53,2,1,152,57.236842105263165,47.58064516129033
35183076,36,10,1,15,1,0,63,84.12698412698413,62.96296296296296
35183088,19,92,10,59,3,1,184,50,44.242424242424235
35183097,72,52,8,43,2,1,178,70.78651685393258,50.943396226415096
35183106,54,48,6,30,1,0,139,65.46762589928056,43.529411764705884
35183118,84,29,4,29,0,0,146,80.13698630136986,53.2258064516129
35183143,29,28,2,15,0,0,74,62.16216216216216,37.77777777777778
35183155,88,25,2,22,0,0,137,81.75182481751825,48.97959183673469
35183167,58,80,2,45,0,0,185,56.75675675675676,37.00787401574803
35183179,120,45,1,39,0,0,205,78.04878048780488,47.05882352941176
35183180,101,51,5,20,1,0,178,71.34831460674158,33.76623376623377
35183192,68,49,2,38,2,1,160,69.375,46.7391304347826
35183209,80,79,5,19,2,0,185,57.29729729729729,24.761904761904763
35183210,107,74,5,18,0,0,204,63.725490196078425,23.71134020618557
35183222,14,68,1,16,0,0,99,31.313131313131315,19.999999999999996
35183234,35,48,2,21,1,0,107,55.140186915887845,33.333333333333336
35183246,58,205,7,137,1,0,408,49.754901960784316,41.42857142857142
35183258,3,51,0,15,0,0,69,26.086956521739136,22.72727272727273
35183261,15,11,3,31,0,0,60,81.66666666666667,75.55555555555556
35183271,118,35,2,19,2,0,176,80.11363636363636,39.6551724137931
35183283,38,14,1,9,0,0,62,77.41935483870968,41.666666666666664
35183295,264,61,5,75,4,1,410,85.1219512195122,58.21917808219178
35183313,21,21,0,12,1,1,56,62.5,40
35183325,50,42,9,22,0,11,134,68.65671641791045,50
35183337,32,25,2,18,0,3,80,68.75,47.916666666666664
35183349,139,54,3,29,8,1,234,76.92307692307692,43.15789473684211
35183350,31,31,0,15,0,0,77,59.74025974025974,32.608695652173914
35183362,130,58,4,41,2,1,236,75.42372881355932,45.28301886792453
35183374,17,75,3,49,0,16,160,53.125,47.55244755244755
35183386,78,38,1,17,2,0,136,72.05882352941177,34.48275862068966
35183398,50,98,9,67,0,1,225,56.44444444444445,43.99999999999999
35183404,45,53,4,59,0,0,161,67.0807453416149,54.310344827586206
35183441,4,114,14,74,4,1,211,45.97156398104265,44.927536231884055
35183453,0,53,13,63,0,0,129,58.914728682170534,58.914728682170534
35183465,71,41,4,36,0,0,152,73.02631578947368,49.382716049382715
35183477,70,25,4,32,0,0,131,80.91603053435115,59.01639344262295
35183489,64,19,3,42,0,0,128,85.15625,70.3125
35183490,181,51,6,60,1,0,299,82.94314381270902,56.779661016949156
35183507,26,50,12,125,0,0,213,76.52582159624413,73.2620320855615
35183519,39,30,6,57,0,0,132,77.27272727272727,67.74193548387098
35183532,0,44,3,102,0,0,149,70.46979865771812,70.46979865771812
35183544,21,21,1,33,0,0,76,72.36842105263158,61.81818181818181
35183556,0,76,10,72,0,0,158,51.89873417721519,51.89873417721519
35183568,26,46,1,33,1,0,107,57.009345794392516,43.20987654320988
35183573,22,78,8,45,0,0,153,49.01960784313726,40.458015267175576
35183593,161,22,3,19,0,0,205,89.26829268292683,50
35183600,79,16,1,19,0,0,115,86.08695652173914,55.55555555555556
35183611,52,28,2,18,0,0,100,72,41.666666666666664
35183623,26,119,9,46,1,0,201,40.79601990049751,31.999999999999996
35183635,50,32,1,11,0,0,94,65.95744680851064,27.27272727272727
35183659,0,70,8,83,1,0,162,56.790123456790134,56.790123456790134
35183660,102,23,2,26,0,0,153,84.9673202614379,54.90196078431373
35183684,99,35,3,29,0,0,166,78.91566265060241,47.76119402985075
35183702,110,52,2,19,2,0,185,71.89189189189189,30.666666666666664
35183714,102,28,3,16,0,0,149,81.20805369127517,40.42553191489362
35183726,24,16,2,11,1,0,54,70.37037037037037,46.666666666666664
35183738,61,27,7,60,1,1,157,82.80254777070064,71.875
35183748,128,19,0,11,0,0,158,87.9746835443038,36.66666666666667
35183751,93,25,4,38,1,0,161,84.472049689441,63.23529411764706
35183763,14,71,5,22,0,0,112,36.60714285714286,27.55102040816326
35183775,89,32,7,64,0,0,192,83.33333333333334,68.93203883495146
35183787,25,34,12,21,2,0,94,63.829787234042556,50.72463768115942
35183799,152,60,8,37,0,1,258,76.74418604651163,43.39622641509434
35183805,18,19,0,30,0,0,67,71.64179104477613,61.224489795918366
35183829,22,60,3,36,0,0,121,50.413223140495866,39.39393939393939
35183830,83,47,6,16,0,0,152,69.07894736842105,31.88405797101449
35183842,70,17,8,20,1,0,116,85.34482758620689,63.04347826086957
35183854,35,31,1,21,1,0,89,65.1685393258427,42.592592592592595
35183885,38,34,9,37,0,0,118,71.1864406779661,57.49999999999999
35183891,7,29,5,27,1,1,70,58.57142857142856,53.968253968253975
35183912,56,17,4,26,0,0,103,83.49514563106796,63.829787234042556
35183921,33,42,1,81,0,0,157,73.2484076433121,66.12903225806453
35183933,95,20,2,25,2,0,144,86.11111111111111,59.183673469387756
35183945,16,26,0,34,0,0,76,65.78947368421053,56.666666666666664
35183957,59,49,3,45,1,0,157,68.78980891719746,50
35183969,12,44,5,75,0,0,136,67.64705882352942,64.51612903225806
35183970,4,57,6,77,0,0,144,60.41666666666667,59.285714285714285
35183982,26,25,2,42,0,0,95,73.6842105263158,63.76811594202898
35183994,72,39,3,35,0,0,149,73.8255033557047,49.350649350649356
35184007,28,31,4,16,1,0,80,61.25000000000001,40.38461538461539
35184019,133,50,4,38,0,0,225,77.77777777777779,45.652173913043484
35184020,66,29,1,58,0,0,154,81.16883116883116,67.04545454545455
35184032,8,29,4,54,0,0,95,69.47368421052632,66.66666666666667
35184056,59,24,5,36,0,0,124,80.64516129032258,63.07692307692307
35184068,14,103,7,79,0,0,203,49.26108374384236,45.5026455026455
35184081,23,56,2,60,0,0,141,60.28368794326241,52.542372881355924
35184147,5,31,4,40,0,0,80,61.25000000000001,58.666666666666664
35184159,29,27,0,9,0,0,65,58.46153846153845,25
35184160,24,27,4,24,0,0,79,65.82278481012658,50.90909090909091
35184172,117,137,7,73,0,1,335,59.1044776119403,37.15596330275229
35184184,25,47,2,30,0,0,104,54.807692307692314,40.50632911392405
35184202,41,51,5,43,0,0,140,63.57142857142857,48.484848484848484
35184226,7,55,16,45,0,0,123,55.28455284552846,52.58620689655172
35184248,73,37,5,44,0,1,160,76.875,57.47126436781609
35184251,55,48,0,34,0,0,137,64.96350364963503,41.463414634146346
35184287,93,42,0,15,1,0,151,72.18543046357617,27.586206896551722
35184299,52,31,3,49,0,0,135,77.03703703703704,62.65060240963856
35184305,197,42,8,63,0,0,310,86.45161290322581,62.83185840707964
35184317,97,49,3,84,0,0,233,78.96995708154506,63.970588235294116
35184329,102,29,2,54,0,0,187,84.49197860962568,65.88235294117646
35184330,346,132,5,92,0,1,576,77.08333333333334,42.608695652173914
35184342,131,38,2,28,2,0,201,81.09452736318407,45.714285714285715
35184354,110,70,4,66,0,0,250,72,50
35184366,20,56,2,39,0,0,117,52.13675213675213,42.26804123711341
35184378,180,43,18,51,1,0,293,85.32423208191126,61.946902654867266
35184385,150,7,4,25,0,0,186,96.23655913978494,80.55555555555556
35184391,66,21,2,30,0,1,120,82.5,61.111111111111114
35184421,17,55,3,95,0,0,170,67.64705882352942,64.05228758169935
35184433,126,18,1,22,0,0,167,89.22155688622755,56.09756097560976
35184470,124,18,0,22,1,1,166,89.1566265060241,57.14285714285714
35184494,26,47,4,62,0,0,139,66.18705035971223,58.4070796460177
35184500,130,30,2,61,0,0,223,86.54708520179372,67.74193548387098
35184512,108,73,3,34,0,1,219,66.66666666666667,34.23423423423423
35184536,121,29,2,64,0,0,216,86.57407407407408,69.47368421052632
35184548,82,47,1,16,0,0,146,67.8082191780822,26.5625
35184559,55,11,0,1,0,0,67,83.5820895522388,8.333333333333337
35184561,50,30,5,16,1,1,103,70.87378640776699,43.39622641509434
35184573,82,19,5,38,0,0,144,86.80555555555556,69.35483870967742
35184585,17,29,2,27,0,0,75,61.33333333333333,50
35184597,0,51,6,63,0,0,120,57.49999999999999,57.49999999999999
35184652,52,9,2,6,0,0,69,86.95652173913044,47.05882352941176
35184664,95,31,1,33,0,0,160,80.625,52.3076923076923
35184676,87,40,6,26,1,0,160,75,45.205479452054796
35184688,77,50,2,41,1,0,171,70.76023391812866,46.808510638297875
35184697,133,18,1,38,0,0,190,90.52631578947368,68.42105263157895
35184731,97,95,0,7,25,0,224,57.58928571428572,25.196850393700785
35185036,19,40,6,32,0,0,97,58.76288659793815,48.71794871794872
35185346,52,236,6,13,1,0,308,23.376623376623375,7.8125
35185437,248,179,4,54,3,0,488,63.31967213114754,25.416666666666664
35185449,103,203,5,31,21,0,363,44.0771349862259,21.923076923076923
35185450,34,60,4,12,0,0,110,45.45454545454546,21.052631578947366
35185486,16,46,1,8,1,0,72,36.111111111111114,17.85714285714286
35185565,201,223,5,42,4,3,478,53.34728033472803,19.494584837545126
35185760,540,197,8,59,0,0,804,75.49751243781094,25.37878787878788
35185802,53,47,3,6,0,0,109,56.88073394495412,16.07142857142857
35187185,113,194,8,51,1,0,367,47.13896457765667,23.62204724409449
35187197,108,31,4,25,0,0,168,81.54761904761905,48.33333333333333
35187513,109,371,13,93,35,2,623,40.44943820224719,27.82101167315175
35187537,468,496,27,129,5,0,1125,55.91111111111111,24.505327245053277
35187549,31,78,2,26,1,0,138,43.47826086956522,27.10280373831776
35187550,44,106,3,29,0,0,182,41.75824175824175,23.188405797101453
35187562,234,152,5,19,2,0,412,63.106796116504846,14.60674157303371
35188918,95,58,5,7,0,0,165,64.84848484848484,17.14285714285714
35188931,996,328,8,52,0,2,1386,76.33477633477634,15.897435897435896
35189406,35,210,8,19,0,0,272,22.79411764705882,11.392405063291145
35189418,41,229,4,11,0,0,285,19.649122807017537,6.147540983606559
35189424,11,203,2,0,2,0,218,6.880733944954132,1.9323671497584516
35189431,14,51,1,13,0,0,79,35.44303797468354,21.53846153846154
35189443,404,627,15,65,1,0,1112,43.61510791366906,11.440677966101697
35189455,47,86,5,23,0,0,161,46.58385093167702,24.561403508771928
35189650,187,156,0,3,10,0,356,56.17977528089888,7.692307692307687
35189662,28,75,3,5,3,0,114,34.210526315789465,12.790697674418606
35190354,28,80,2,9,0,0,119,32.773109243697476,12.08791208791209
35190469,95,168,6,30,0,1,300,43.99999999999999,18.048780487804883
35191036,36,77,10,24,0,0,147,47.61904761904761,30.630630630630627
35191224,425,418,38,541,1,2,1425,70.66666666666667,58.20000000000001
35191383,91,27,3,33,0,0,154,82.46753246753246,57.14285714285714
35191577,0,93,0,1,1,0,95,2.1052631578947323,2.1052631578947323
35191711,162,98,4,50,0,0,314,68.78980891719746,35.526315789473685
35191863,80,25,3,22,0,0,130,80.76923076923077,50
35191887,6,29,1,3,2,0,41,29.268292682926834,17.14285714285714
35191905,238,411,41,398,5,1,1094,62.43144424131627,51.98598130841121
35191917,44,325,21,395,1,0,786,58.651399491094146,56.19946091644206
35192211,322,241,25,127,1,3,719,66.48122392211404,39.29471032745592
35192223,51,89,3,24,1,0,168,47.023809523809526,23.931623931623935
35192247,78,228,9,31,1,1,348,34.48275862068966,15.555555555555555
35192351,49,108,5,24,1,0,187,42.24598930481284,21.739130434782606
35192387,7,44,3,1,1,0,56,21.42857142857143,10.204081632653061
35192557,94,30,0,24,1,0,149,79.86577181208054,45.45454545454546
35192636,88,28,1,2,0,0,119,76.47058823529412,9.677419354838712
35192752,53,29,2,32,0,0,116,75,53.968253968253975
35192764,6,55,7,57,0,0,125,56.00000000000001,53.78151260504202
35192776,79,62,7,38,1,1,188,67.02127659574468,43.11926605504587
35192788,38,12,1,28,0,0,79,84.81012658227847,70.73170731707317
35192922,98,269,18,75,0,0,460,41.52173913043479,25.690607734806626
35193057,22,63,3,8,2,0,98,35.71428571428571,17.105263157894733
35193240,12,41,1,5,0,0,59,30.508474576271183,12.765957446808507
35193264,135,60,4,21,0,0,220,72.72727272727273,29.411764705882348
35193306,122,387,9,76,1,1,596,35.06711409395973,18.354430379746834
35193318,27,90,8,12,2,0,139,35.251798561151084,19.64285714285714
35193999,42,196,4,9,6,0,257,23.73540856031129,8.837209302325578
35194244,45,100,3,9,0,0,157,36.30573248407644,10.71428571428571
35194918,42,26,2,44,0,0,114,77.19298245614034,63.888888888888886
35195030,50,26,2,11,2,0,91,71.42857142857143,36.58536585365854
35195078,159,90,6,27,0,0,282,68.08510638297872,26.82926829268293
35195182,543,212,12,100,2,1,870,75.63218390804597,35.16819571865444
35195558,22,46,8,27,3,4,110,58.18181818181818,47.72727272727273
35195561,33,46,2,24,4,1,110,58.18181818181818,40.25974025974026
35195972,26,151,1,6,4,0,188,19.680851063829785,6.79012345679012
35198171,63,28,3,24,1,0,119,76.47058823529412,50
35198183,55,18,4,20,1,0,98,81.63265306122449,58.13953488372092
35198870,6126,104,8,64,2,0,6304,98.3502538071066,41.57303370786517
35198882,210,158,11,41,0,0,420,62.38095238095238,24.761904761904763
35198894,160,113,1,16,1,0,291,61.16838487972509,13.740458015267176
35198948,10,48,0,10,1,0,69,30.434782608695656,18.644067796610166
35198959,25,55,0,1,0,0,81,32.098765432098766,1.7857142857142905
35198961,14,95,0,3,1,0,113,15.92920353982301,4.040404040404044
35199084,17,33,1,7,0,0,58,43.103448275862064,19.512195121951216
35199096,34,25,1,9,0,0,69,63.76811594202898,28.57142857142857
35199229,97,113,2,27,1,0,240,52.916666666666664,20.97902097902098
35199242,16,29,5,6,0,0,56,48.21428571428571,27.500000000000004
35199308,10,36,4,3,0,0,53,32.07547169811321,16.279069767441857
35199357,296,463,18,194,1,0,972,52.36625514403293,31.50887573964497
35199400,73,74,3,15,0,0,165,55.15151515151515,19.565217391304344
35199473,49,102,1,7,0,0,159,35.84905660377359,7.272727272727275
35199597,17,157,1,2,3,0,180,12.777777777777777,3.6809815950920255
35199606,21,116,0,0,2,0,139,16.546762589928054,1.6949152542372836
35199618,22,61,0,4,1,0,88,30.681818181818176,7.57575757575758
35199680,34,34,1,6,0,0,75,54.666666666666664,17.07317073170732
35199710,239,160,1,13,0,3,416,61.53846153846154,9.6045197740113
35199734,13,32,0,5,0,0,50,36,13.513513513513509
35199825,59,198,4,12,0,0,273,27.472527472527474,7.476635514018692
35199874,5,53,1,1,0,0,60,11.66666666666667,3.6363636363636376
35199904,73,12,0,1,0,0,86,86.04651162790698,7.692307692307687
35199928,35,121,1,15,0,0,172,29.651162790697672,11.678832116788318
35199965,15,43,2,8,4,0,72,40.27777777777778,24.561403508771928
35200001,93,245,34,187,2,2,563,56.48312611012434,47.87234042553191
35200013,111,79,7,46,0,0,243,67.48971193415639,40.15151515151515
35200025,250,514,73,279,5,8,1129,54.472984942426926,41.52445961319682
35200037,439,416,31,324,0,3,1213,65.70486397361913,46.253229974160206
35200049,120,220,36,448,1,0,825,73.33333333333334,68.79432624113475
35200050,335,312,36,173,0,3,859,63.67869615832363,40.458015267175576
35200062,288,492,82,470,9,1,1342,63.33830104321907,53.32068311195446
35200074,12,80,3,193,0,1,289,72.31833910034602,71.11913357400722
35200086,262,261,23,226,4,2,778,66.45244215938304,49.41860465116279
35200098,369,385,35,571,2,0,1362,71.73274596182085,61.228600201409876
35200529,16,153,19,81,0,0,269,43.122676579925646,39.52569169960475
35200530,124,83,6,73,0,0,286,70.97902097902097,48.76543209876543
35201923,319,272,37,220,2,3,853,68.11254396248533,49.063670411985015
35201935,327,153,14,128,1,1,624,75.48076923076923,48.484848484848484
35201947,101,534,33,293,1,4,966,44.72049689440993,38.26589595375722
35201959,442,440,61,316,3,6,1268,65.29968454258675,46.73123486682809
35201960,458,463,38,398,4,0,1361,65.9808963997061,48.72646733111849
35201972,91,480,56,531,2,3,1163,58.7274290627687,55.223880597014926
35207627,165,137,23,221,0,1,547,74.95429616087752,64.13612565445025
35207639,89,609,52,310,2,2,1064,42.76315789473685,37.53846153846154
35207640,92,123,5,73,0,0,293,58.02047781569966,38.80597014925373
35207652,116,107,5,75,0,0,303,64.6864686468647,42.78074866310161
35207664,181,80,7,51,1,1,321,75.0778816199377,42.85714285714286
35207676,203,281,73,231,1,2,791,64.47534766118837,52.210884353741505
35207688,80,82,1,32,3,1,199,58.79396984924623,31.092436974789916
35207697,71,73,2,41,0,3,190,61.578947368421055,38.65546218487395
35207706,130,121,12,135,6,8,412,70.63106796116504,57.09219858156028
35207718,177,64,8,25,0,0,274,76.64233576642336,34.02061855670103
35207724,3,192,12,115,0,0,322,40.37267080745342,39.81191222570533
35207731,48,39,1,5,1,0,94,58.51063829787234,15.217391304347828
35207743,100,137,12,94,1,1,345,60.28985507246376,44.08163265306122
35207755,307,679,39,471,3,2,1501,54.763491005996,43.132328308207704
35207767,164,162,15,183,1,1,526,69.20152091254752,55.24861878453038
35207779,101,458,57,614,2,0,1232,62.824675324675326,59.50486295313881
35207780,321,66,7,72,0,0,466,85.83690987124464,54.48275862068965
35207792,213,79,5,33,3,0,333,76.27627627627628,34.166666666666664
35207809,68,139,4,143,0,0,354,60.73446327683616,51.39860139860139
35207810,214,74,7,84,1,0,380,80.52631578947368,55.42168674698795
35207822,517,365,32,278,1,0,1193,69.40486169321039,46.00591715976331
35207834,548,522,86,575,8,0,1739,69.98274870615296,56.17128463476071
35207846,197,145,9,208,0,0,559,74.0608228980322,59.94475138121547
35207858,222,135,12,109,1,2,481,71.93347193347192,47.876447876447884
35207861,439,455,27,335,1,0,1257,63.80270485282418,44.37652811735941
35207871,354,108,7,116,3,1,589,81.66383701188455,54.04255319148936
35207883,79,77,13,54,7,5,235,67.2340425531915,50.641025641025635
35207895,161,184,5,126,1,0,477,61.425576519916135,41.77215189873418
35207901,279,121,3,55,0,0,458,73.58078602620087,32.402234636871505
35207913,193,47,9,68,0,2,319,85.26645768025078,62.698412698412696
35207925,110,59,8,34,1,0,212,72.16981132075472,42.15686274509803
35207937,221,59,11,60,1,0,352,83.23863636363636,54.961832061068705
35207949,498,230,34,293,1,3,1059,78.28139754485363,59.0017825311943
35207950,92,127,24,162,0,0,405,68.64197530864197,59.424920127795524
35207962,578,640,45,969,5,3,2240,71.42857142857143,61.492178098676284
35223141,497,332,33,277,4,6,1149,71.10530896431679,49.079754601227
35223153,162,112,7,47,1,0,329,65.95744680851064,32.93413173652695
35223165,249,228,29,302,0,1,809,71.81705809641532,59.285714285714285
35223177,7,285,12,309,2,0,615,53.65853658536586,53.125
35223189,22,153,11,54,1,2,243,37.03703703703704,30.76923076923077
35223190,143,106,9,95,3,2,358,70.39106145251397,50.69767441860464
35223207,260,88,5,37,0,1,391,77.49360613810742,32.82442748091603
35223219,290,382,27,207,0,5,911,58.068057080131716,38.48631239935588
35223220,164,76,10,45,7,0,302,74.83443708609272,44.927536231884055
35223232,550,330,43,215,2,3,1143,71.12860892388451,44.35075885328836
35223244,216,48,4,74,0,0,342,85.96491228070175,61.904761904761905
35223256,145,89,17,149,2,0,402,77.86069651741295,65.36964980544747
35223268,167,42,7,54,2,0,272,84.55882352941177,60
35223273,234,95,8,47,1,1,386,75.38860103626943,37.5
35224224,158,84,14,138,2,0,396,78.78787878787878,64.70588235294117
35224236,87,183,14,105,0,1,390,53.07692307692308,39.603960396039604
35224248,195,73,11,120,2,0,401,81.79551122194513,64.5631067961165
35233882,491,396,47,279,9,3,1225,67.6734693877551,46.049046321525886
35233894,223,421,53,469,1,0,1167,63.924592973436155,55.402542372881356
35233900,448,367,34,426,1,0,1276,71.23824451410658,55.67632850241546
35233912,490,203,14,214,1,2,924,78.03030303030303,53.2258064516129
35233924,78,37,6,28,0,0,149,75.16778523489933,47.887323943661976
35233936,15,203,31,145,0,0,394,48.47715736040609,46.437994722955146
35233948,501,420,51,549,0,0,1521,72.38658777120315,58.82352941176471
35233959,524,403,36,559,1,1,1524,73.55643044619423,59.699999999999996
35233961,287,282,38,413,4,0,1024,72.4609375,61.73677069199457
35233973,540,321,46,333,0,1,1241,74.13376309427882,54.20827389443652
35233985,374,238,21,237,2,0,872,72.70642201834863,52.208835341365464
35233997,344,502,39,331,2,0,1218,58.78489326765188,42.56292906178489
35236883,67,45,2,30,0,0,144,68.75,41.55844155844156
35236895,77,12,3,15,0,0,107,88.78504672897196,60
35236901,81,22,4,18,0,0,125,82.4,50
35236913,103,21,2,15,0,0,141,85.1063829787234,44.73684210526315
35236925,80,21,0,21,0,0,122,82.78688524590164,50
35236937,59,46,2,11,0,0,118,61.01694915254237,22.033898305084744
35236949,106,18,1,8,0,0,133,86.46616541353383,33.333333333333336
35236950,47,29,3,40,0,0,119,75.63025210084034,59.72222222222222
35236962,57,46,5,10,0,1,119,61.34453781512605,25.806451612903224
35236974,136,25,1,11,0,0,173,85.54913294797689,32.432432432432435
35236986,52,56,2,17,0,1,128,56.25,26.315789473684216
35236998,62,36,1,33,0,0,132,72.72727272727273,48.57142857142858
35237000,89,29,0,5,0,0,123,76.42276422764228,14.70588235294118
35237012,59,39,2,14,0,0,114,65.78947368421053,29.09090909090909
35237024,96,60,3,36,0,0,195,69.23076923076923,39.39393939393939
35237036,50,62,2,19,1,1,135,54.074074074074076,27.058823529411768
35237048,73,37,4,25,0,0,139,73.38129496402878,43.939393939393945
35237059,71,30,0,26,1,0,128,76.5625,47.36842105263158
35237061,39,45,0,31,1,0,116,61.206896551724135,41.55844155844156
35237073,42,32,6,40,0,0,120,73.33333333333334,58.97435897435898
35237085,84,22,5,20,1,0,132,83.33333333333334,54.16666666666667
35237097,76,28,2,19,0,0,125,77.60000000000001,42.85714285714286
35237103,75,21,11,12,0,0,119,82.35294117647058,52.27272727272727
35237115,2,87,8,40,1,5,143,39.16083916083915,38.297872340425535
35237127,54,33,4,16,0,0,107,69.1588785046729,37.735849056603776
35237139,18,44,4,43,0,0,109,59.63302752293578,51.64835164835164
35237140,81,32,2,32,0,0,147,78.2312925170068,51.515151515151516
35237152,39,40,3,35,0,0,117,65.8119658119658,48.71794871794872
35237164,55,55,1,22,0,0,133,58.64661654135339,29.487179487179482
35237176,58,19,1,12,0,0,90,78.88888888888889,40.625
35237188,0,60,7,59,0,0,126,52.38095238095239,52.38095238095239
35237197,7,53,4,57,0,1,122,56.55737704918033,53.91304347826087
35237206,54,31,6,10,0,0,101,69.3069306930693,34.04255319148937
35237218,51,34,1,32,1,0,119,71.42857142857143,50
35237224,62,28,1,31,0,0,122,77.04918032786885,53.333333333333336
35237231,7,52,2,56,0,1,118,55.93220338983051,53.153153153153156
35237243,44,41,3,37,0,1,126,67.46031746031747,50
35237255,76,23,3,28,0,0,130,82.3076923076923,57.407407407407405
35237267,43,16,0,42,0,0,101,84.15841584158416,72.41379310344827
35237279,19,54,13,93,0,1,180,70,66.45962732919256
35237280,67,26,0,29,0,0,122,78.68852459016394,52.727272727272734
35237292,68,20,0,25,0,0,113,82.30088495575221,55.55555555555556
35237309,58,35,5,13,3,0,114,69.29824561403508,37.5
35237310,36,55,3,28,1,1,124,55.64516129032258,37.5
35237322,56,14,1,18,0,0,89,84.26966292134833,57.57575757575757
35237334,3,28,0,108,0,0,139,79.85611510791367,79.41176470588236
35237346,54,22,3,42,2,0,123,82.11382113821138,68.11594202898551
35237358,0,62,7,58,1,0,128,51.5625,51.5625
35237361,10,55,11,30,1,0,107,48.5981308411215,43.29896907216495
35237371,184,46,0,44,0,0,274,83.21167883211679,48.88888888888889
35237383,91,18,3,14,0,0,126,85.71428571428572,48.57142857142858
35237395,41,54,1,15,1,0,112,51.78571428571428,23.943661971830988
35237401,103,14,0,10,0,0,127,88.9763779527559,41.666666666666664
35237413,85,29,4,29,0,0,147,80.27210884353741,53.2258064516129
35237425,9,86,11,38,0,0,144,40.27777777777778,36.29629629629629
35237437,86,10,3,16,0,0,115,91.30434782608697,65.51724137931035
35237449,102,27,3,29,0,0,161,83.22981366459628,54.23728813559322
35237450,53,16,8,23,0,0,100,84,65.95744680851064
35237462,1,72,8,49,0,5,135,46.666666666666664,46.26865671641791
35237474,26,55,6,23,0,0,110,50,34.523809523809526
35237486,129,41,11,42,1,0,224,81.69642857142857,56.84210526315789
35237498,87,46,1,15,1,0,150,69.33333333333334,26.984126984126988
35237504,76,18,1,10,0,0,105,82.85714285714285,37.93103448275862
35237516,85,16,4,18,0,0,123,86.99186991869918,57.89473684210527
35237528,149,20,1,16,0,0,186,89.24731182795699,45.945945945945944
35237536,42,62,6,26,3,0,139,55.39568345323741,36.08247422680413
35237541,59,36,3,15,0,0,113,68.14159292035397,33.333333333333336
35237553,50,30,1,23,0,0,104,71.15384615384616,44.44444444444444
35237565,49,42,18,25,0,0,134,68.65671641791045,50.588235294117645
35237577,60,63,5,25,0,0,153,58.82352941176471,32.25806451612904
35237589,87,30,5,22,0,0,144,79.16666666666666,47.36842105263158
35237590,106,21,2,15,0,0,144,85.41666666666666,44.73684210526315
35237607,92,23,7,22,0,0,144,84.02777777777779,55.769230769230774
35237619,71,37,7,17,0,0,132,71.96969696969697,39.34426229508197
35237620,46,39,5,18,0,0,108,63.888888888888886,37.096774193548384
35237632,60,26,4,26,1,0,117,77.77777777777779,54.385964912280706
35237644,60,19,2,20,0,0,101,81.1881188118812,53.65853658536586
35237656,60,26,4,26,0,1,117,77.77777777777779,54.385964912280706
35237668,58,38,3,47,1,0,147,74.14965986394557,57.30337078651686
35237673,30,62,8,33,1,0,134,53.73134328358209,40.38461538461539
35237681,50,50,2,23,0,0,125,60,33.333333333333336
35237693,71,32,4,27,1,0,135,76.29629629629629,50
35237700,26,75,8,36,1,0,146,48.630136986301366,37.5
35237711,73,38,2,26,0,0,139,72.66187050359711,42.42424242424242
35237723,2,54,16,46,0,0,118,54.23728813559322,53.448275862068975
35237735,84,13,6,6,0,2,111,88.28828828828829,51.85185185185186
35237747,8,69,7,21,0,0,105,34.285714285714285,28.865979381443296
35237759,65,39,2,21,0,0,127,69.29133858267717,37.096774193548384
35237760,69,22,3,5,0,0,99,77.77777777777779,26.66666666666667
35237772,66,45,2,28,0,1,142,68.30985915492957,40.789473684210535
35237784,106,31,1,14,0,0,152,79.60526315789474,32.608695652173914
35237796,84,31,2,14,4,2,137,77.37226277372262,41.509433962264154
35237802,111,32,2,15,0,0,160,80,34.693877551020414
35237814,64,32,1,20,0,0,117,72.64957264957265,39.62264150943396
35237826,74,29,3,12,0,0,118,75.42372881355932,34.09090909090909
35237838,7,53,16,44,1,0,121,56.19834710743802,53.50877192982456
35237848,73,27,6,10,0,0,116,76.72413793103449,37.2093023255814
35237851,59,20,0,12,0,0,91,78.02197802197803,37.5
35237863,66,22,3,48,0,0,139,84.17266187050359,69.86301369863014
35237875,75,23,7,29,0,0,134,82.83582089552239,61.01694915254237
35237887,104,19,4,36,0,0,163,88.34355828220859,67.79661016949152
35237899,19,69,11,39,0,0,138,50,42.01680672268907
35237905,98,21,2,13,0,0,134,84.32835820895522,41.666666666666664
35237917,64,34,1,21,1,0,121,71.900826446281,40.35087719298246
35237929,54,37,2,16,0,1,110,66.36363636363636,33.92857142857143
35237930,85,21,1,14,0,0,121,82.64462809917356,41.666666666666664
35237942,46,72,9,22,1,0,150,52,30.76923076923077
35237954,2,65,4,42,0,0,113,42.47787610619469,41.44144144144144
35237966,68,30,7,12,0,0,117,74.35897435897436,38.775510204081634
35237978,59,49,3,45,0,0,156,68.58974358974359,49.48453608247423
35237985,18,33,5,35,0,0,91,63.73626373626373,54.794520547945204
35237991,57,17,4,25,1,0,104,83.65384615384616,63.829787234042556
35238004,12,59,1,50,1,0,123,52.032520325203244,46.846846846846844
35238016,8,51,4,68,1,0,132,61.36363636363637,58.87096774193547
35238028,3,78,4,57,0,0,142,45.070422535211264,43.88489208633094
35238036,75,21,0,10,0,0,106,80.18867924528301,32.25806451612904
35238041,74,25,2,32,1,0,134,81.34328358208955,58.33333333333333
35238053,89,26,2,23,0,0,140,81.42857142857143,49.01960784313726
35238065,52,36,0,5,0,0,93,61.29032258064516,12.195121951219512
35238077,4,37,8,35,0,0,84,55.952380952380956,53.75
35238089,51,48,16,16,0,0,131,63.3587786259542,40
35238090,77,31,3,29,0,0,140,77.85714285714286,50.79365079365079
35238107,25,18,1,9,0,0,53,66.03773584905662,35.71428571428571
35238119,17,80,6,60,1,2,166,51.80722891566265,46.308724832214764
35238120,63,28,2,20,0,0,113,75.2212389380531,43.99999999999999
35238132,33,70,3,36,0,0,142,50.70422535211267,35.77981651376147
35238144,87,40,1,9,1,0,138,71.01449275362319,21.568627450980394
35238156,91,36,4,11,0,0,142,74.64788732394366,29.411764705882348
35238168,55,98,10,35,2,0,200,51,32.41379310344827
35238173,123,24,4,17,0,0,168,85.71428571428572,46.666666666666664
35238181,98,26,3,18,0,0,145,82.06896551724138,44.680851063829785
35238193,80,57,5,18,0,0,160,64.375,28.749999999999996
35238200,63,49,3,30,3,0,148,66.89189189189189,42.352941176470594
35238223,103,39,0,17,0,0,159,75.47169811320755,30.35714285714286
35238235,20,68,13,35,0,0,136,50,41.379310344827594
35238247,45,94,4,28,1,1,173,45.66473988439307,26.5625
35238259,1,120,13,92,0,0,226,46.90265486725663,46.666666666666664
35238260,55,93,9,28,0,0,185,49.72972972972973,28.46153846153846
35238272,66,116,0,22,0,0,204,43.13725490196079,15.94202898550725
35238284,66,40,3,24,2,0,135,70.37037037037037,42.028985507246375
35238296,32,61,5,57,0,2,157,61.146496815286625,51.2
35238302,75,44,5,21,1,0,146,69.86301369863014,38.02816901408451
35238314,46,60,6,44,1,4,161,62.732919254658384,47.82608695652174
35238326,71,44,4,45,0,0,164,73.17073170731707,52.68817204301075
35238338,61,52,2,37,0,0,152,65.78947368421053,42.85714285714286
35238348,42,52,13,32,1,4,144,63.888888888888886,49.01960784313726
35238351,65,76,7,40,9,1,198,61.61616161616161,42.85714285714286
35238363,121,16,4,20,0,0,161,90.06211180124224,60
35238375,98,24,1,23,0,1,147,83.6734693877551,51.02040816326531
35238387,53,76,4,21,3,0,157,51.59235668789809,26.923076923076927
35238399,59,34,4,11,1,0,109,68.80733944954129,31.999999999999996
35238405,60,53,2,27,1,0,143,62.93706293706294,36.14457831325302
35238417,75,17,3,53,0,1,149,88.59060402684564,77.02702702702703
35238429,1,66,5,75,0,3,150,56.00000000000001,55.70469798657718
35238430,46,56,5,58,1,0,166,66.26506024096386,53.333333333333336
35238442,52,63,3,30,0,0,148,57.432432432432435,34.375
35238454,1,90,3,66,1,2,163,44.78527607361963,44.44444444444444
35238466,42,61,0,45,1,1,150,59.33333333333333,43.518518518518526
35238478,2,75,7,74,0,0,158,52.53164556962025,51.92307692307692
35238485,58,18,1,18,0,0,95,81.05263157894737,51.35135135135135
35238491,48,44,2,66,0,0,160,72.5,60.71428571428572
35238508,85,35,3,35,0,0,158,77.84810126582279,52.05479452054795
35238512,52,32,6,27,1,0,118,72.88135593220339,51.515151515151516
35238521,120,39,8,24,0,0,191,79.58115183246073,45.070422535211264
35238533,12,19,1,24,0,0,56,66.07142857142857,56.81818181818181
35238545,2,78,2,15,3,0,100,21.999999999999996,20.408163265306122
35238557,23,53,3,44,0,1,124,57.258064516129025,47.524752475247524
35238569,90,32,2,32,0,0,156,79.48717948717949,51.515151515151516
35238570,75,36,3,38,0,0,152,76.31578947368422,53.24675324675325
35238582,34,61,1,10,2,0,108,43.518518518518526,17.567567567567565
35238594,48,73,5,17,2,0,145,49.6551724137931,24.742268041237114
35238600,32,32,6,25,1,0,96,66.66666666666667,50
35238612,32,52,7,28,0,0,119,56.30252100840336,40.22988505747126
35238624,21,29,4,14,0,0,68,57.35294117647059,38.297872340425535
35238636,82,42,1,25,0,0,150,72,38.23529411764706
35238648,18,49,3,20,0,0,90,45.55555555555556,31.944444444444443
35238659,51,57,7,41,0,0,156,63.46153846153846,45.714285714285715
35238673,44,64,5,32,0,0,145,55.86206896551724,36.633663366336634
35238685,23,42,8,36,1,0,110,61.81818181818181,51.72413793103448
35238697,131,25,0,23,3,0,182,86.26373626373626,50.98039215686274
35238703,56,23,1,25,0,0,105,78.0952380952381,53.06122448979591
35238715,1,83,11,64,0,0,159,47.79874213836478,47.46835443037975
35238727,52,59,3,56,0,0,170,65.29411764705883,50
35238739,1,40,7,48,0,1,97,58.76288659793815,58.33333333333333
35238740,5,46,11,40,0,0,102,54.90196078431373,52.57731958762887
35238752,4,46,7,32,0,0,89,48.31460674157303,45.88235294117647
35238764,52,20,4,28,0,0,104,80.76923076923077,61.53846153846154
35238776,9,53,7,64,0,0,133,60.150375939849624,57.258064516129025
35238788,162,23,3,16,1,0,205,88.78048780487805,46.51162790697675
35238797,10,100,14,114,1,0,239,58.15899581589959,56.33187772925764
35238806,31,58,7,72,0,3,171,66.08187134502924,58.57142857142856
35238818,15,63,8,43,0,0,129,51.162790697674424,44.73684210526315
35238824,118,17,4,10,1,1,151,88.74172185430463,48.484848484848484
35238831,44,45,10,33,1,0,133,66.16541353383458,49.43820224719101
35238843,80,48,12,29,0,0,169,71.59763313609467,46.06741573033708
35238855,177,46,5,35,0,0,263,82.50950570342206,46.51162790697675
35238867,82,35,1,29,0,0,147,76.19047619047619,46.15384615384615
35238879,92,14,1,31,0,0,138,89.85507246376811,69.56521739130434
35238880,34,50,12,53,0,0,149,66.44295302013423,56.52173913043479
35238892,70,38,6,35,1,0,150,74.66666666666666,52.5
35238909,11,50,7,38,0,0,106,52.83018867924528,47.36842105263158
35238910,40,44,11,36,0,0,131,66.41221374045801,51.64835164835164
35238922,0,56,5,46,0,0,107,47.663551401869164,47.663551401869164
35238934,0,71,7,58,0,0,136,47.79411764705882,47.79411764705882
35238946,97,43,3,95,3,0,241,82.15767634854771,70.13888888888889
35238958,27,38,1,38,0,0,104,63.46153846153846,50.64935064935065
35238961,0,57,8,78,0,0,143,60.13986013986015,60.13986013986015
35238971,80,30,5,37,0,0,152,80.26315789473684,58.33333333333333
35238983,2,34,5,44,0,0,85,60,59.036144578313255
35238995,24,33,7,35,0,0,99,66.66666666666667,56.00000000000001
35239008,22,30,6,41,0,0,99,69.6969696969697,61.038961038961034
35239012,66,28,3,29,2,0,128,78.125,54.83870967741935
35239021,12,70,6,64,1,0,153,54.2483660130719,50.35460992907801
35239033,13,71,4,76,1,0,165,56.96969696969697,53.289473684210535
35239045,111,63,6,48,0,1,229,72.48908296943232,46.61016949152542
35239057,2,32,21,95,0,0,150,78.66666666666666,78.37837837837837
35239069,2,71,4,85,0,0,162,56.17283950617284,55.625
35239070,12,56,8,47,0,0,123,54.47154471544715,49.54954954954955
35239082,50,24,2,47,0,0,123,80.48780487804879,67.12328767123287
35239094,0,73,5,82,0,0,160,54.37499999999999,54.37499999999999
35239100,45,29,4,49,0,0,127,77.16535433070865,64.63414634146342
35239112,15,55,9,53,0,0,132,58.33333333333333,52.991452991452995
35239124,65,22,2,31,0,1,121,81.81818181818181,60.71428571428572
35239136,47,36,3,56,1,1,144,75,62.88659793814433
35239148,41,32,7,40,0,0,120,73.33333333333334,59.493670886075954
35239159,61,14,1,6,0,0,82,82.92682926829268,33.333333333333336
35239161,2,63,10,68,0,0,143,55.94405594405594,55.319148936170215
35239173,102,22,2,20,0,0,146,84.93150684931507,50
35239185,15,56,13,76,1,0,161,65.21739130434783,61.64383561643836
35239197,42,46,6,39,1,1,135,65.92592592592592,50.53763440860215
35239203,2,83,1,51,0,0,137,39.41605839416058,38.51851851851852
35239215,81,41,1,22,1,0,146,71.91780821917808,36.92307692307693
35239227,21,37,2,23,0,0,83,55.42168674698795,40.32258064516129
35239239,38,29,2,27,9,0,105,72.38095238095238,56.71641791044777
35239240,80,27,5,23,0,0,135,80,50.90909090909091
35239264,65,27,3,36,0,0,131,79.38931297709924,59.09090909090908
35239276,54,40,2,29,1,0,126,68.25396825396825,44.44444444444444
35239288,44,38,0,48,0,0,130,70.76923076923076,55.81395348837209
35239297,102,44,5,58,0,0,209,78.94736842105263,58.87850467289719
35239306,65,27,6,43,1,0,142,80.98591549295774,64.93506493506493
35239318,55,35,6,47,0,0,143,75.52447552447552,60.22727272727273
35239324,58,30,3,49,0,0,140,78.57142857142857,63.41463414634146
35239331,34,70,6,62,0,0,172,59.302325581395344,49.27536231884058
35239343,127,45,5,91,1,0,269,83.27137546468401,68.30985915492957
35239355,65,30,7,40,0,0,142,78.87323943661973,61.038961038961034
35239367,82,46,9,53,0,1,191,75.91623036649214,57.798165137614674
35239379,44,29,0,37,0,0,110,73.63636363636363,56.060606060606055
35239380,10,41,3,63,0,0,117,64.95726495726495,61.68224299065421
35239392,29,62,11,51,0,0,153,59.47712418300654,50
35239409,75,35,2,27,0,0,139,74.82014388489209,45.3125
35239410,104,18,0,25,1,0,148,87.83783783783784,59.09090909090908
35239422,1,77,14,29,1,17,139,44.60431654676259,44.20289855072463
35239434,69,37,3,7,1,6,123,69.91869918699187,31.481481481481477
35239446,108,16,1,12,0,0,137,88.32116788321169,44.827586206896555
35239458,71,16,0,12,0,0,99,83.83838383838383,42.85714285714286
35239461,7,47,10,38,0,0,102,53.92156862745099,50.526315789473685
35239471,23,36,3,31,0,0,93,61.29032258064516,48.57142857142858
35239495,46,25,3,22,0,0,96,73.95833333333333,50
35239501,50,35,1,11,0,1,98,64.28571428571428,27.083333333333336
35239513,71,65,4,29,1,0,170,61.76470588235294,34.34343434343434
35239525,16,86,2,41,0,1,146,41.0958904109589,33.84615384615385
35239549,93,21,0,5,1,0,120,82.5,22.22222222222222
35239550,76,23,6,25,0,0,130,82.3076923076923,57.407407407407405
35239562,91,31,3,11,1,0,137,77.37226277372262,32.608695652173914
35239574,69,29,5,1,0,0,104,72.11538461538461,17.14285714285714
35239586,88,33,4,15,0,0,140,76.42857142857142,36.53846153846154
35239598,49,43,2,20,0,0,114,62.28070175438596,33.84615384615385
35242196,364,254,53,409,1,0,1081,76.5032377428307,64.57461645746166
35242202,688,624,56,704,3,5,2080,70,55.172413793103445
35242214,160,89,14,125,0,4,392,77.29591836734694,61.63793103448276
35242226,95,214,12,160,3,0,484,55.78512396694215,44.987146529562985
35242248,205,285,22,290,0,0,802,64.46384039900249,52.26130653266332
35242251,232,171,16,150,0,0,569,69.94727592267137,49.25816023738873
35242263,30,358,61,539,2,1,991,63.874873864783055,62.7471383975026
35242275,3,187,13,255,0,1,459,59.25925925925925,58.99122807017544
35242287,423,369,26,224,4,0,1046,64.72275334608031,40.77046548956661
35242299,568,411,33,278,2,1,1293,68.21345707656612,43.31034482758621
35242317,188,63,8,40,6,1,306,79.41176470588236,46.61016949152542
35243589,35,162,12,133,2,0,344,52.90697674418605,47.57281553398058
35243590,5,88,9,120,1,1,224,60.71428571428572,59.817351598173516
35243607,600,413,23,239,6,4,1285,67.85992217898833,39.70802919708029
35243619,146,560,64,213,1,1,985,43.147208121827404,33.25387365911799
35243693,12,52,1,2,0,0,67,22.388059701492537,5.454545454545457
35245148,371,454,97,581,7,1,1511,69.9536730641959,60.175438596491226
35245159,62,54,6,53,0,0,175,69.14285714285715,52.212389380530965
35245161,169,230,11,306,3,0,719,68.01112656467316,58.18181818181818
35245173,57,348,27,192,0,0,624,44.230769230769226,38.62433862433863
35245185,166,468,37,627,4,4,1306,64.16539050535988,58.94736842105264
35245987,21,110,2,9,3,0,145,24.13793103448276,11.290322580645162
35246116,69,38,4,45,0,0,156,75.64102564102564,56.32183908045977
35246220,115,257,28,126,0,2,528,51.32575757575757,37.772397094430985
35246360,280,354,43,420,0,2,1099,67.78889899909008,56.776556776556774
35246499,336,381,30,246,3,0,996,61.74698795180723,42.27272727272727
35246645,58,251,13,222,0,1,545,53.94495412844036,48.45995893223819
35247546,215,372,10,278,0,1,876,57.53424657534247,43.721633888048416
35247558,242,246,19,122,0,0,629,60.89030206677266,36.434108527131784
35248393,283,483,34,293,1,2,1096,55.93065693430657,40.59040590405905
35249312,354,451,19,254,1,1,1080,58.24074074074075,37.878787878787875
35249324,302,40,6,42,0,1,391,89.769820971867,55.0561797752809
35249749,224,460,65,705,0,4,1458,68.44993141289437,62.72285251215559
35249750,230,410,34,219,1,2,896,54.24107142857143,38.43843843843844
35249762,88,30,6,31,0,0,155,80.64516129032258,55.223880597014926
35249774,165,127,6,114,2,0,414,69.32367149758454,48.99598393574297
35249786,96,305,30,186,0,0,617,50.56726094003241,41.45873320537427
35249798,466,546,48,776,1,3,1840,70.32608695652173,60.26200873362446
35249804,522,356,27,334,5,3,1247,71.45148356054531,50.89655172413793
35249816,313,46,7,91,0,0,457,89.93435448577681,68.05555555555556
35249828,281,392,17,262,7,0,959,59.12408759124088,42.182890855457224
35249993,324,437,70,392,0,2,1225,64.3265306122449,51.49833518312985
35250211,296,57,10,39,0,2,404,85.89108910891089,47.22222222222222
35250260,417,304,25,120,1,0,867,64.9365628604383,32.44444444444444
35250296,79,113,2,8,0,0,202,44.059405940594054,8.130081300813007
35250405,50,34,3,8,0,0,95,64.21052631578948,24.444444444444446
35250512,59,22,3,8,4,1,97,77.31958762886599,42.10526315789473
35251008,195,98,19,62,3,2,379,74.14248021108179,46.7391304347826
35252165,29,18,1,5,0,1,54,66.66666666666667,28.000000000000004
35252323,25,12,2,2,0,0,41,70.73170731707317,25
35253923,329,172,29,97,2,1,630,72.69841269841271,42.85714285714286
35253935,29,13,6,10,0,0,58,77.58620689655173,55.172413793103445
35255440,209,42,11,27,0,1,290,85.51724137931033,48.14814814814815
35255452,46,53,1,15,1,0,116,54.310344827586206,24.28571428571429
35255555,55,61,2,15,0,0,133,54.13533834586466,21.794871794871796
35255592,105,50,11,25,0,1,192,73.95833333333333,42.52873563218391
35255610,27,17,1,4,11,0,60,71.66666666666667,48.484848484848484
35255661,176,75,9,84,1,1,346,78.32369942196532,55.88235294117647
35255671,228,78,19,71,0,0,396,80.3030303030303,53.57142857142857
35255737,265,219,10,39,0,1,534,58.98876404494382,18.587360594795545
35256432,117,282,19,195,5,0,618,54.36893203883495,43.712574850299404
35256456,104,365,50,333,5,4,861,57.60743321718931,51.78335535006605
35256468,266,228,61,237,6,1,799,71.46433041301627,57.2232645403377
35256473,51,316,86,443,2,2,900,64.88888888888889,62.77974087161367
35256481,191,230,76,216,0,1,714,67.78711484593838,56.022944550669216
35256493,159,289,79,273,0,5,805,64.09937888198758,55.263157894736835
35256500,273,432,147,612,3,2,1469,70.59223961878828,63.87959866220736
35256511,91,261,49,303,5,4,713,63.394109396914445,58.038585209003216
35256523,126,76,8,58,1,0,269,71.74721189591078,46.85314685314685
35256547,275,136,28,106,9,0,554,75.45126353790614,51.25448028673836
35256808,67,19,2,7,0,1,96,80.20833333333334,34.48275862068966
35256812,68,16,2,8,8,0,102,84.31372549019608,52.94117647058824
35257187,141,21,1,13,0,0,176,88.06818181818181,40
35257205,40,125,1,12,2,2,182,31.318681318681318,11.971830985915489
35257497,785,245,18,189,2,3,1242,80.27375201288245,46.389496717724285
35257813,73,145,7,71,1,0,297,51.178451178451176,35.26785714285714
35257916,338,12748,1551,1470,150,34,16291,21.74820453010865,20.090265153889554
35258039,354,284,5,107,5,1,756,62.433862433862444,29.35323383084577
35258124,96,41,4,27,0,0,168,75.59523809523809,43.05555555555556
35258428,465,410,154,551,5,3,1588,74.18136020151134,63.4906500445236
35258436,27,290,89,407,4,0,817,64.50428396572828,63.29113924050633
35258842,51,27,1,15,0,0,94,71.27659574468085,37.2093023255814
35259147,3084,1531,80,375,36,3,5109,70.03327461342728,24.395061728395063
35259214,64,289,51,110,1,2,517,44.10058027079303,36.203090507726266
35259305,19,59,0,3,0,0,81,27.160493827160494,4.8387096774193505
35259421,86,237,87,215,0,1,626,62.14057507987221,56.111111111111114
35259639,54,61,4,9,0,0,128,52.34375,17.567567567567565
35259731,70,393,108,356,0,0,927,57.60517799352751,54.14235705950992
35259834,3,43,0,7,1,0,54,20.370370370370374,15.686274509803921
35260162,39,19,5,2,0,0,65,70.76923076923076,26.923076923076927
35260228,107,421,76,340,6,1,951,55.730809674027334,50.11848341232228
35260373,52,72,2,16,0,0,142,49.29577464788733,19.999999999999996
35260423,144,52,15,37,0,0,248,79.03225806451613,50
35260824,99,11,1,7,0,0,118,90.67796610169492,42.10526315789473
35260903,59,22,5,14,1,0,101,78.21782178217822,47.61904761904761
35260939,144,167,6,58,1,0,376,55.58510638297872,28.01724137931034
35260940,157,68,4,33,0,0,262,74.04580152671755,35.238095238095234
35262699,17,22,0,2,0,0,41,46.34146341463414,8.333333333333337
35262705,67,21,5,17,0,0,110,80.9090909090909,51.162790697674424
35263357,36,51,2,11,0,0,100,49,20.3125
35263795,130,119,7,23,5,0,284,58.098591549295776,22.72727272727273
35263928,83,56,10,17,1,1,168,66.66666666666667,34.11764705882353
35264921,229,130,19,104,0,3,485,73.1958762886598,49.21875
35265068,370,94,8,123,3,0,598,84.2809364548495,58.77192982456141
35265147,940,329,76,325,3,2,1675,80.35820895522387,55.23809523809524
35265536,30,28,5,11,0,0,74,62.16216216216216,36.36363636363637
35265925,120,61,8,31,0,0,220,72.27272727272727,39
35265998,10,26,5,13,0,1,55,52.727272727272734,42.22222222222223
35266127,73,187,7,64,1,0,332,43.674698795180724,27.7992277992278
35266139,29,15,1,1,0,0,46,67.3913043478261,11.764705882352944
35266197,0,40,1,4,0,0,45,11.111111111111116,11.111111111111116
35266218,3,29,1,30,0,0,63,53.968253968253975,51.66666666666666
35266231,13,59,4,7,0,0,83,28.915662650602414,15.714285714285714
35266395,17,32,2,7,0,0,58,44.827586206896555,21.95121951219512
35266474,7,48,0,3,2,0,60,19.999999999999996,9.433962264150942
35266528,70,415,5,24,8,0,522,20.498084291187734,8.185840707964598
35266759,19,23,1,14,0,0,57,59.64912280701755,39.473684210526315
35266760,11,113,4,9,0,0,137,17.51824817518248,10.317460317460315
35266772,76,157,9,59,0,0,301,47.840531561461795,30.222222222222218
35266796,10,23,3,17,0,0,53,56.60377358490566,46.51162790697675
35266802,16,42,2,6,0,0,66,36.36363636363637,16.000000000000004
35266838,5,144,2,15,0,0,166,13.253012048192769,10.559006211180122
35266875,63,169,6,24,0,1,263,35.74144486692015,15.500000000000004
35266930,37,64,4,30,0,0,135,52.59259259259259,34.693877551020414
35266966,15,111,0,7,1,0,134,17.16417910447762,6.72268907563025
35267028,57,45,0,2,0,0,104,56.730769230769226,4.255319148936165
35267041,11,35,1,8,0,0,55,36.36363636363637,20.45454545454546
35267119,20,40,1,9,0,0,70,42.85714285714286,19.999999999999996
35267181,5,0,0,0,0,120,125,100,100
35267193,1,0,0,0,0,42,43,100,100
35267200,8,0,0,0,0,109,117,100,100
35267880,133,118,3,45,2,0,301,60.797342192691026,29.761904761904766
35267971,119,168,21,197,1,0,506,66.798418972332,56.58914728682171
35267983,563,563,20,437,0,3,1586,64.50189155107188,44.965786901270775
35268012,57,56,2,44,1,0,160,65,45.63106796116505
35268021,68,43,5,43,1,0,160,73.125,53.260869565217384
35268082,87,31,1,18,0,0,137,77.37226277372262,38
35268094,150,33,1,44,0,0,228,85.52631578947368,57.692307692307686
35268100,252,46,2,32,3,0,335,86.26865671641791,44.57831325301205
35268112,190,26,5,24,1,1,247,89.47368421052632,54.385964912280706
35268124,179,51,4,22,1,1,258,80.23255813953489,35.44303797468354
35268276,379,113,13,131,0,1,637,82.26059654631084,56.201550387596896
35268288,317,140,15,63,0,1,536,73.88059701492537,36.073059360730596
35268380,110,64,15,82,2,0,273,76.55677655677655,60.73619631901841
35268690,157,48,5,33,1,1,245,80.40816326530611,45.45454545454546
35268938,47,20,4,17,0,1,89,77.52808988764045,52.38095238095239
35268948,45,26,0,4,8,0,83,68.67469879518072,31.57894736842105
35268987,84,59,5,62,0,0,210,71.9047619047619,53.17460317460318
35268999,269,77,8,111,1,0,466,83.47639484978541,60.913705583756354
35269189,110,96,4,24,0,4,238,59.66386554621849,25
35269190,130,43,6,22,0,0,201,78.60696517412936,39.43661971830986
35269300,205,33,15,19,0,0,272,87.86764705882352,50.74626865671642
35269359,218,278,23,226,2,2,749,62.88384512683578,47.64595103578154
35269360,510,301,25,220,4,0,1060,71.60377358490567,45.27272727272727
35269372,440,234,16,171,3,0,864,72.91666666666667,44.811320754716974
35269384,400,371,49,431,3,3,1257,70.48528241845663,56.70945157526255
35269475,67,33,3,24,0,0,127,74.01574803149606,44.99999999999999
35269499,302,122,14,114,2,0,554,77.9783393501805,51.58730158730158
35269505,20,146,13,183,1,1,364,59.89010989010989,57.55813953488372
35270386,417,126,10,93,0,1,647,80.52550231839258,45.21739130434783
35270398,146,89,3,107,1,0,346,74.27745664739885,55.49999999999999
35270404,392,144,18,206,4,1,765,81.17647058823529,61.3941018766756
35270623,218,131,11,86,0,0,446,70.62780269058295,42.54385964912281
35270635,139,90,11,158,1,0,399,77.44360902255639,65.38461538461539
35270647,210,110,9,207,0,1,537,79.51582867783985,66.36085626911314
35271007,260,77,14,67,2,0,420,81.66666666666667,51.87500000000001
35271019,348,462,44,316,9,0,1179,60.81424936386768,44.4043321299639
35271020,246,378,79,260,2,3,968,60.9504132231405,47.64542936288089
35271032,108,417,32,279,1,0,837,50.17921146953406,42.79835390946503
35271044,235,134,7,89,2,1,468,71.36752136752136,42.4892703862661
35271056,2,207,24,190,1,1,425,51.294117647058826,51.06382978723405
35271068,310,433,55,572,1,3,1374,68.48617176128093,59.30451127819549
35271073,324,377,48,438,2,2,1191,68.34592779177162,56.51672433679353
35271081,467,366,42,311,1,2,1189,69.21783010933558,49.30747922437673
35271093,24,129,13,76,0,0,242,46.69421487603306,40.825688073394495
35271100,148,231,26,158,5,1,569,59.402460456941995,45.13064133016626
35271111,434,426,55,356,4,0,1275,66.58823529411765,49.34601664684899
35271123,287,125,13,72,2,1,500,75,41.31455399061033
35271135,243,124,13,107,0,0,487,74.53798767967146,49.18032786885246
35271147,399,406,35,343,6,0,1189,65.85365853658536,48.607594936708864
35271159,308,395,43,454,3,5,1208,67.30132450331125,56.111111111111114
35271160,497,337,45,424,4,2,1309,74.25515660809778,58.49753694581281
35271172,195,141,1,43,0,0,380,62.89473684210527,23.783783783783786
35271184,257,116,8,79,0,0,460,74.78260869565217,42.85714285714286
35271196,610,265,26,439,1,2,1343,80.2680565897245,63.84720327421556
35271202,27,198,21,288,1,2,537,63.12849162011174,61.1764705882353
35271214,183,86,7,180,0,0,456,81.14035087719299,68.4981684981685
35271226,741,287,40,511,2,3,1584,81.88131313131312,65.95492289442467
35271238,252,111,9,94,4,0,470,76.38297872340425,49.082568807339456
35271248,172,498,39,560,6,0,1275,60.94117647058823,54.850407978241165
35271251,219,80,13,225,0,0,537,85.10242085661079,74.8427672955975
35271792,4,187,16,165,0,0,372,49.73118279569893,49.184782608695656
35274070,24,19,2,7,0,0,52,63.46153846153846,32.14285714285714
35275013,118,233,12,152,1,0,516,54.84496124031008,41.4572864321608
35275323,303,120,9,106,3,3,544,77.94117647058823,50.20746887966805
35276133,206,122,13,91,2,0,434,71.88940092165899,46.49122807017544
35276157,203,81,8,55,0,0,347,76.657060518732,43.75
35278920,141,77,8,29,1,0,256,69.921875,33.04347826086956
35278932,204,101,11,103,0,1,420,75.95238095238095,53.24074074074075
35278944,227,52,2,26,0,0,307,83.06188925081433,35
35279080,159,105,5,30,2,0,301,65.11627906976744,26.056338028169012
35279249,30,12,1,23,0,0,66,81.81818181818181,66.66666666666667
35279250,66,30,0,56,1,0,153,80.3921568627451,65.51724137931035
35279262,72,20,3,48,0,2,145,86.20689655172413,72.6027397260274
35279274,63,20,2,13,1,0,99,79.7979797979798,44.44444444444444
35279286,133,25,5,19,0,0,182,86.26373626373626,48.97959183673469
35279298,96,32,4,15,0,0,147,78.2312925170068,37.254901960784316
35279304,105,24,7,20,0,0,156,84.61538461538461,52.94117647058824
35279316,61,14,2,9,0,0,86,83.72093023255813,43.99999999999999
35279328,77,28,8,17,1,0,131,78.62595419847328,48.14814814814815
35279336,66,46,7,40,0,0,159,71.06918238993711,50.53763440860215
35279341,33,25,3,25,0,0,86,70.93023255813952,52.83018867924528
35279353,57,22,3,33,0,0,115,80.8695652173913,62.06896551724138
35279365,97,26,2,34,0,0,159,83.64779874213836,58.06451612903225
35279377,168,30,4,30,1,1,234,87.17948717948718,54.54545454545454
35279389,72,31,0,7,1,0,111,72.07207207207207,20.512820512820518
35279894,131,122,11,107,1,0,372,67.20430107526883,49.37759336099585
35280331,235,406,51,310,6,1,1009,59.762140733399406,47.5452196382429
35280343,34,20,2,22,0,0,78,74.35897435897436,54.54545454545454
35280355,69,41,3,19,0,0,132,68.93939393939394,34.92063492063492
35280422,228,553,28,285,5,0,1099,49.681528662420384,36.5097588978186
35280434,152,94,4,43,1,0,294,68.02721088435374,33.80281690140845
35280446,88,16,6,13,0,0,123,86.99186991869918,54.28571428571429
35280458,54,31,2,24,0,0,111,72.07207207207207,45.614035087719294
35280461,47,34,2,35,1,0,119,71.42857142857143,52.77777777777778
35280471,76,30,5,15,0,0,126,76.19047619047619,40
35280483,57,33,3,19,1,1,114,71.05263157894737,42.10526315789473
35280653,20,46,2,12,1,0,81,43.20987654320988,24.590163934426236
35280677,30,44,4,27,0,0,105,58.09523809523809,41.333333333333336
35280719,20,27,3,2,0,0,52,48.07692307692307,15.625
35280823,213,65,10,200,0,0,488,86.68032786885246,76.36363636363637
35280835,86,26,1,15,0,1,129,79.84496124031007,39.53488372093024
35280847,250,209,22,211,2,0,694,69.88472622478386,52.92792792792793
35280859,64,51,6,21,0,0,142,64.08450704225352,34.61538461538461
35280860,54,25,1,28,0,0,108,76.85185185185185,53.703703703703695
35280872,111,16,1,11,0,0,139,88.48920863309353,42.85714285714286
35280884,100,237,25,221,6,2,591,59.89847715736041,51.73116089613035
35281438,238,351,34,345,8,4,980,64.18367346938776,52.695417789757414
35282285,206,117,9,177,1,0,510,77.05882352941177,61.513157894736835
35282297,93,115,13,200,2,1,424,72.87735849056604,65.25679758308158
35282303,206,102,9,76,3,2,398,74.37185929648241,46.875
35282315,64,17,0,47,2,0,130,86.92307692307692,74.24242424242425
35282327,201,149,17,157,1,0,525,71.61904761904762,54.01234567901234
35282339,48,39,7,25,1,0,120,67.5,45.833333333333336
35282340,106,9,3,19,0,0,137,93.43065693430657,70.96774193548387
35282352,74,8,1,4,0,0,87,90.80459770114942,38.46153846153846
35282364,56,42,5,17,0,0,120,65,34.375
35282376,186,150,33,177,0,0,546,72.52747252747253,58.33333333333333
35282388,61,34,6,52,0,1,154,77.92207792207793,63.44086021505376
35282397,104,428,51,514,2,1,1100,61.090909090909086,57.028112449799195
35282479,167,105,13,179,17,4,485,78.35051546391753,66.98113207547169
35282480,365,413,74,333,1,2,1188,65.23569023569024,49.81773997569866
35283289,7,62,5,61,0,0,135,54.074074074074076,51.5625
35283605,126,84,11,265,1,0,487,82.75154004106776,76.73130193905817
35283617,53,42,9,54,0,0,158,73.41772151898735,60
35283885,213,176,21,227,0,2,639,72.45696400625978,58.68544600938967
35283903,315,269,24,340,3,0,951,71.71398527865405,57.70440251572326
35284300,345,364,44,350,3,0,1106,67.08860759493672,52.16819973718791
35284324,684,305,31,238,1,1,1260,75.79365079365078,47.048611111111114
35284749,6,58,2,21,0,0,87,33.333333333333336,28.395061728395067
35285584,67,18,4,36,0,0,125,85.6,68.96551724137932
35285614,190,57,0,32,1,0,280,79.64285714285715,36.66666666666667
35285663,118,28,7,16,0,0,169,83.4319526627219,45.09803921568627
35285791,100,25,6,27,0,0,158,84.17721518987342,56.896551724137936
35285808,340,84,18,87,1,0,530,84.15094339622642,55.78947368421052
35286394,54,243,1,0,25,1,324,25,9.999999999999998
35286448,308,312,33,289,0,0,942,66.87898089171975,50.78864353312302
35286540,21,28,1,5,0,0,55,49.09090909090909,17.647058823529417
35286655,31,85,3,7,1,0,127,33.07086614173228,11.458333333333337
35286916,75,127,14,64,8,10,298,57.38255033557047,43.04932735426009
35286928,42,21,3,17,1,0,84,75,50
35286941,39,19,1,5,0,0,64,70.3125,24
35287039,97,285,17,42,2,2,445,35.95505617977528,18.103448275862068
35287040,21,21,2,5,0,0,49,57.14285714285714,25
35287076,242,103,16,158,0,2,521,80.23032629558541,63.08243727598566
35287258,193,120,15,58,1,0,387,68.9922480620155,38.144329896907216
35287295,33,25,0,22,0,0,80,68.75,46.808510638297875
35287301,58,30,1,37,2,1,129,76.74418604651163,57.74647887323944
35287313,43,3,1,8,1,0,56,94.64285714285714,76.92307692307692
35287436,138,137,15,72,2,0,364,62.362637362637365,39.38053097345132
35287441,111,26,0,1,0,0,138,81.15942028985508,3.703703703703709
35287532,181,109,10,43,1,2,346,68.4971098265896,33.93939393939394
35287556,25,139,3,14,0,0,181,23.20441988950276,10.897435897435892
35287581,256,370,5,20,8,0,659,43.854324734446124,8.188585607940446
35287600,22,41,1,0,1,0,65,36.92307692307693,4.651162790697672
35287672,165,128,14,130,1,0,438,70.77625570776256,53.11355311355312
35287748,20,52,2,23,0,1,98,46.93877551020408,33.333333333333336
35287912,1,70,0,0,0,0,71,1.4084507042253502,0
35288184,48,66,2,5,0,0,121,45.45454545454546,9.589041095890416
35288226,29,18,0,23,0,0,70,74.28571428571429,56.09756097560976
35288238,125,32,1,18,0,1,177,81.92090395480226,38.46153846153846
35288251,42,25,0,7,2,0,76,67.10526315789474,26.470588235294112
35288494,38,131,20,61,2,0,252,48.01587301587301,38.78504672897196
35288512,46,34,5,15,0,0,100,65.99999999999999,37.03703703703704
35288559,30,57,1,13,1,0,102,44.11764705882353,20.833333333333336
35288561,143,281,5,34,6,1,470,40.212765957446805,14.067278287461772
35288573,117,214,4,37,2,1,375,42.93333333333334,17.05426356589147
35288676,57,9,0,13,0,0,79,88.60759493670886,59.09090909090908
35288731,74,32,1,19,0,0,126,74.60317460317461,38.46153846153846
35288743,52,20,4,44,0,0,120,83.33333333333334,70.58823529411764
35288755,76,40,2,76,0,0,194,79.38144329896907,66.10169491525424
35288925,94,13,3,24,0,0,134,90.29850746268657,67.5
35289334,205,106,12,81,0,0,404,73.76237623762376,46.733668341708544
35289929,39,89,4,53,0,0,185,51.891891891891895,39.04109589041096
35290038,54,104,1,23,0,0,182,42.85714285714286,18.75
35290166,53,28,2,16,0,0,99,71.71717171717171,39.13043478260869
35290178,137,42,3,70,2,0,254,83.46456692913385,64.1025641025641
35290373,75,26,8,21,2,0,132,80.3030303030303,54.385964912280706
35290415,252,372,13,71,1,0,709,47.531734837799725,18.59956236323851
35290427,37,33,6,7,0,0,83,60.24096385542168,28.260869565217394
35290543,429,591,57,291,0,0,1368,56.79824561403508,37.060702875399365
35290579,45,37,1,43,1,1,128,71.09375,55.42168674698795
35290646,3014,2127,118,814,30,6,6109,65.18251759698805,31.276252019386106
35290701,612,623,67,407,3,2,1714,63.65227537922987,43.46642468239564
35290841,27,53,2,0,0,0,82,35.36585365853659,3.6363636363636376
35290993,173,238,9,67,14,0,501,52.49500998003992,27.439024390243905
35291031,59,32,2,12,0,0,105,69.52380952380952,30.434782608695656
35291195,47,84,5,89,0,0,225,62.66666666666667,52.80898876404494
35291481,83,24,5,15,1,1,129,81.3953488372093,47.82608695652174
35291500,109,98,6,17,0,0,230,57.391304347826086,19.00826446280992
35291511,377,360,12,83,3,0,835,56.88622754491017,21.397379912663762
35291766,56,20,2,36,0,0,114,82.45614035087719,65.51724137931035
35292175,202,353,2,7,15,0,579,39.03281519861831,6.366047745358094
35292643,36,8,1,15,0,0,60,86.66666666666667,66.66666666666667
35292709,51,4,0,1,0,0,56,92.85714285714286,19.999999999999996
35292850,29,122,8,14,1,0,174,29.885057471264364,15.86206896551724
35292874,8,51,0,5,0,0,64,20.3125,8.92857142857143
35292898,3,64,1,1,0,0,69,7.246376811594201,3.0303030303030276
35293003,10,106,3,67,1,1,188,43.61702127659575,40.44943820224719
35293088,72,13,0,0,0,0,85,84.70588235294117,0
35293155,1,80,3,6,1,0,91,12.08791208791209,11.111111111111116
35293234,15,37,0,8,0,0,60,38.33333333333333,17.777777777777782
35293246,2,88,0,1,0,0,91,3.296703296703296,1.1235955056179803
35293453,20,55,0,8,0,0,83,33.734939759036145,12.698412698412698
35293465,1,100,0,4,3,0,108,7.4074074074074066,6.542056074766355
35293490,0,36,0,6,0,0,42,14.28571428571429,14.28571428571429
35293532,233,473,27,81,0,0,814,41.891891891891895,18.58864027538726
35293556,3,123,0,0,0,0,126,2.3809523809523836,0
35293568,0,42,0,0,0,0,42,0,0
35293593,24,49,15,49,6,0,143,65.73426573426573,58.82352941176471
35293600,142,39,1,15,0,0,197,80.20304568527918,29.09090909090909
35293635,87,237,11,68,0,0,403,41.19106699751861,25
35293659,48,94,1,6,1,0,150,37.33333333333333,7.843137254901967
35293684,41,5,0,1,0,0,47,89.36170212765957,16.666666666666664
35293702,87,29,5,19,0,1,141,79.43262411347519,46.29629629629629
35293799,58,17,1,16,0,0,92,81.5217391304348,50
35293830,2,69,0,0,0,0,71,2.8169014084507005,0
35293854,6,89,0,6,2,0,103,13.592233009708742,8.247422680412376
35293912,0,40,1,30,0,0,71,43.66197183098591,43.66197183098591
35293933,6,29,0,6,0,0,41,29.268292682926834,17.14285714285714
35293945,22,40,1,6,0,0,69,42.028985507246375,14.893617021276595
35294019,34,70,4,15,1,0,124,43.548387096774185,22.22222222222222
35294123,33,20,0,7,0,0,60,66.66666666666667,25.92592592592593
35294147,17,41,5,14,0,0,77,46.753246753246756,31.666666666666664
35294299,4,87,3,6,0,0,100,13,9.375
35294330,6,35,2,16,0,0,59,40.67796610169492,33.9622641509434
35294354,15,55,2,4,0,0,76,27.631578947368418,9.836065573770492
35294385,6,22,3,10,0,0,41,46.34146341463414,37.142857142857146
35294408,9,70,1,1,0,0,81,13.580246913580252,2.777777777777779
35294559,63,20,2,23,0,0,108,81.4814814814815,55.55555555555556
35294597,153,111,7,36,3,1,311,64.30868167202573,29.746835443037977
35294724,62,95,3,29,0,0,189,49.735449735449734,25.196850393700785
35294767,7,31,3,12,0,0,53,41.509433962264154,32.608695652173914
35294780,33,48,15,13,0,0,109,55.96330275229357,36.8421052631579
35294810,6,31,0,4,0,0,41,24.390243902439025,11.428571428571432
35294861,89,16,0,0,0,0,105,84.76190476190476,0
35294895,85,2,0,1,0,0,88,97.72727272727273,33.333333333333336
35294962,121,6,0,0,0,0,127,95.2755905511811,0
35294974,2,40,0,0,0,0,42,4.761904761904767,0
35295164,1170,417,53,382,7,6,2035,79.5085995085995,51.79190751445086
35295176,133,141,2,47,1,0,324,56.48148148148149,26.178010471204193
35295188,183,304,16,172,2,1,678,55.16224188790561,38.58585858585859
35295206,29,86,4,64,0,1,184,53.260869565217384,44.516129032258064
35295224,54,19,1,20,0,0,94,79.7872340425532,52.5
35295231,74,23,3,12,2,0,114,79.82456140350878,42.50000000000001
35295243,17,27,3,20,0,0,67,59.70149253731343,46
35295322,62,27,1,7,0,0,97,72.16494845360825,22.857142857142854
35295346,29,11,1,26,0,0,67,83.5820895522388,71.05263157894737
35295401,82,38,1,22,0,0,143,73.42657342657343,37.704918032786885
35295450,119,7,0,1,0,0,127,94.48818897637796,12.5
35295462,20,123,3,10,25,0,181,32.04419889502762,23.60248447204969
35295589,31,221,0,3,1,0,256,13.671875,1.7777777777777781
35295619,10,73,1,6,0,0,90,18.88888888888889,8.750000000000002
35295656,51,15,6,16,0,0,88,82.95454545454545,59.45945945945945
35295929,84,122,4,42,0,0,252,51.58730158730158,27.380952380952383
35295942,22,32,10,32,1,0,97,67.01030927835052,57.33333333333333
35295985,12,17,4,22,0,0,55,69.0909090909091,60.46511627906976
35296004,18,83,2,13,1,1,118,29.66101694915254,17.000000000000004
35296016,63,145,5,13,4,0,230,36.95652173913043,13.173652694610782
35296211,23,18,0,26,0,0,67,73.13432835820896,59.09090909090908
35296223,14,29,6,18,0,0,67,56.71641791044777,45.28301886792453
35296314,64,21,1,23,0,0,109,80.73394495412845,53.333333333333336
35296326,34,21,0,15,0,0,70,70,41.666666666666664
35296405,31,32,0,5,1,0,69,53.623188405797094,15.789473684210531
35296454,18,41,4,7,0,0,70,41.42857142857142,21.153846153846157
35296569,93,42,3,34,1,0,173,75.72254335260115,47.5
35296624,67,75,4,15,2,0,163,53.987730061349694,21.875
35296636,186,142,23,132,1,0,484,70.66115702479338,52.348993288590606
35296740,614,118,15,167,1,0,915,87.10382513661202,60.797342192691026
35297410,142,103,1,7,0,0,253,59.28853754940712,7.207207207207212
35297501,289,548,46,489,6,3,1381,60.318609703113694,49.81684981684982
35297574,39,21,3,7,0,0,70,70,32.25806451612904
35297586,66,53,8,44,1,1,173,69.36416184971098,50.46728971962617
35297616,68,27,3,7,0,0,105,74.28571428571429,27.027027027027028
35298177,816,607,131,495,6,1,2056,70.47665369649805,51.04838709677419
35298189,175,63,6,69,0,0,313,79.87220447284345,54.347826086956516
35298190,111,40,10,47,1,0,209,80.86124401913875,59.183673469387756
35298220,107,62,6,35,0,0,210,70.47619047619047,39.80582524271845
35298232,561,621,59,655,5,4,1905,67.40157480314961,53.79464285714286
35298244,223,122,16,115,0,1,477,74.42348008385744,51.96850393700787
35298256,56,72,4,69,1,0,202,64.35643564356435,50.68493150684932
35298268,730,307,32,200,1,0,1270,75.8267716535433,43.148148148148145
35298273,146,266,23,181,0,0,616,56.81818181818181,43.40425531914893
35298281,147,75,2,70,1,0,295,74.57627118644068,49.32432432432432
35298293,404,350,52,289,1,0,1096,68.06569343065694,49.42196531791907
35298300,257,161,17,150,2,1,588,72.61904761904762,51.359516616314195
35298311,75,63,5,48,0,0,191,67.01570680628272,45.689655172413794
35298323,64,45,3,20,3,0,135,66.66666666666667,36.61971830985915
35299297,189,174,16,82,1,0,462,62.33766233766234,36.26373626373627
35299364,212,250,21,83,9,3,578,56.747404844290664,31.693989071038253
35299571,46,212,8,23,0,0,289,26.643598615916954,12.757201646090532
35299583,68,160,5,46,0,0,279,42.65232974910395,24.17061611374408
35299613,191,304,3,34,2,0,534,43.07116104868914,11.370262390670549
35299625,29,382,2,20,1,0,434,11.981566820276502,5.679012345679013
35299637,35,71,6,21,0,0,133,46.616541353383454,27.55102040816326
35299698,150,59,7,55,2,0,273,78.3882783882784,52.032520325203244
35299873,259,86,14,133,0,0,492,82.52032520325203,63.0901287553648
35299935,16,82,3,5,0,0,106,22.64150943396226,8.888888888888891
35299972,51,120,1,2,0,0,174,31.034482758620683,2.4390243902439046
35299984,54,355,2,11,3,0,425,16.470588235294116,4.312668463611857
35300032,27,52,3,8,0,0,90,42.22222222222223,17.460317460317466
35300068,32,45,4,25,0,0,106,57.54716981132076,39.189189189189186
35300317,146,594,113,810,2,2,1667,64.36712657468506,60.946745562130175
35300412,31,88,2,2,2,0,125,29.600000000000005,6.382978723404253
35300433,150,31,4,25,0,0,210,85.23809523809524,48.33333333333333
35300457,171,49,8,34,1,0,263,81.36882129277566,46.7391304347826
35300627,53,16,1,9,0,0,79,79.74683544303798,38.46153846153846
35300861,125,163,15,69,1,0,373,56.30026809651474,34.2741935483871
35300871,45,27,0,0,11,0,83,67.46987951807229,28.947368421052634
35301656,54,19,5,24,0,1,103,81.55339805825243,61.224489795918366
35301985,108,114,8,43,1,1,275,58.54545454545455,31.73652694610778
35302156,260,141,3,10,2,0,416,66.10576923076923,9.615384615384615
35302831,40,136,1,21,7,0,205,33.65853658536585,17.575757575757578
35302855,45,163,0,8,1,0,217,24.884792626728114,5.232558139534882
35303148,6,41,7,97,1,0,152,73.02631578947368,71.91780821917808
35303756,50,139,10,157,1,0,357,61.06442577030813,54.72312703583062
35304475,55,42,8,45,1,0,151,72.18543046357617,56.25
35304487,58,11,4,16,0,1,90,87.77777777777777,65.625
35304499,64,20,8,21,0,0,113,82.30088495575221,59.183673469387756
35304608,35,16,4,13,0,0,68,76.47058823529412,51.515151515151516
35304612,137,0,0,3,0,0,140,100,100
35304621,38,26,2,10,0,0,76,65.78947368421053,31.57894736842105
35304633,46,13,0,17,0,0,76,82.89473684210526,56.666666666666664
35304645,206,51,6,55,1,0,319,84.01253918495297,54.86725663716814
35304815,373,478,32,184,8,4,1079,55.69972196478221,32.29461756373938
35304943,12,29,0,13,0,0,54,46.29629629629629,30.952380952380953
35305017,14,29,4,24,2,1,74,60.810810810810814,51.66666666666666
35305029,43,106,5,34,1,0,189,43.91534391534392,27.397260273972602
35305112,15,80,2,48,0,0,145,44.827586206896555,38.46153846153846
35305388,45,19,2,9,1,0,76,75,38.70967741935484
35305510,99,30,3,2,0,0,134,77.61194029850746,14.28571428571429
35305522,25,17,4,9,0,1,56,69.64285714285714,45.16129032258065
35305534,44,19,1,6,0,0,70,72.85714285714286,26.923076923076927
35305571,64,19,7,27,1,0,118,83.89830508474576,64.81481481481481
35305583,75,13,0,2,0,0,90,85.55555555555556,13.33333333333333
35305613,121,18,2,16,0,0,157,88.53503184713377,50
35305716,27,77,7,4,0,0,115,33.04347826086956,12.5
35305765,3,19,1,43,0,0,66,71.21212121212122,69.84126984126983
35306514,106,54,6,24,1,0,191,71.72774869109948,36.47058823529412
35307592,22,79,1,11,0,0,113,30.08849557522124,13.186813186813184
35307622,755,674,26,169,2,1,1627,58.57406269207131,22.706422018348626
35307634,96,14,0,2,0,0,112,87.5,12.5
35307683,49,19,3,66,1,0,138,86.23188405797102,78.65168539325843
35307836,79,39,8,25,1,1,153,74.50980392156863,47.297297297297305
35307841,24,97,4,77,1,0,203,52.21674876847291,45.81005586592178
35307853,66,28,3,20,1,0,118,76.27118644067797,46.15384615384615
35307865,89,23,3,39,0,0,154,85.06493506493507,64.61538461538461
35307877,99,28,4,26,0,0,157,82.16560509554141,51.72413793103448
35307932,122,27,3,4,0,0,156,82.6923076923077,20.588235294117652
35307956,94,28,2,48,0,0,172,83.72093023255813,64.1025641025641
35307968,114,11,0,32,1,0,158,93.0379746835443,75
35307981,119,14,0,25,1,0,159,91.19496855345912,65
35307993,97,25,4,34,0,0,160,84.375,60.31746031746032
35308006,82,15,2,34,0,1,134,88.80597014925374,71.15384615384616
35308821,52,41,4,25,0,0,122,66.39344262295081,41.42857142857142
35308900,94,15,6,43,0,0,158,90.50632911392404,76.5625
35308912,78,63,4,51,4,0,200,68.5,48.36065573770492
35308961,95,31,5,32,0,0,163,80.98159509202453,54.41176470588236
35309059,43,116,2,34,4,2,201,42.288557213930346,26.582278481012654
35309266,88,33,5,43,0,1,170,80.58823529411765,59.756097560975604
35309485,110,29,4,29,0,0,172,83.13953488372093,53.2258064516129
35309813,140,19,1,18,0,0,178,89.32584269662921,50
35310694,164,28,2,44,1,0,239,88.28451882845188,62.66666666666667
35310712,176,27,0,22,2,0,227,88.10572687224669,47.05882352941176
35310748,55,42,2,69,1,0,169,75.14792899408285,63.1578947368421
35310797,15,48,3,7,0,0,73,34.24657534246576,17.24137931034483
35310955,67,39,0,24,0,0,130,70,38.095238095238095
35311406,88,24,11,15,0,0,138,82.6086956521739,52
35311467,75,33,5,67,1,0,181,81.76795580110497,68.86792452830188
35311571,85,47,10,53,1,0,196,76.0204081632653,57.65765765765766
35311716,66,49,11,70,3,0,199,75.37688442211055,63.1578947368421
35311728,49,82,4,42,1,0,178,53.93258426966292,36.434108527131784
35312204,23,79,7,46,2,0,157,49.681528662420384,41.04477611940298
35312373,157,15,4,11,0,0,187,91.97860962566845,50
35312381,105,29,3,26,0,0,163,82.20858895705521,50
35312587,126,23,1,18,0,0,168,86.30952380952381,45.238095238095234
35312629,55,53,6,46,0,0,160,66.875,49.523809523809526
35312685,16,98,16,31,0,1,162,39.50617283950617,32.87671232876712
35312691,193,29,1,31,0,0,254,88.58267716535433,52.459016393442624
35313524,6,61,3,4,5,1,80,23.750000000000004,17.567567567567565
35314511,15,76,0,0,48,0,139,45.32374100719424,38.70967741935484
35314547,258,102,14,64,0,0,438,76.71232876712328,43.333333333333336
35314717,53,54,0,1,0,0,108,50,1.8181818181818188
35315230,80,8,0,0,0,1,89,91.01123595505618,11.111111111111116
35315242,43,2,0,0,0,0,45,95.55555555555556,0
35315291,9,21,1,13,0,0,44,52.27272727272727,40
35315333,10,105,0,2,0,0,117,10.256410256410254,1.869158878504673
35315369,12,15,0,17,0,0,44,65.90909090909092,53.125
35317949,0,72,0,0,4,0,76,5.263157894736848,5.263157894736848
35319272,65,46,4,53,0,0,168,72.61904761904762,55.33980582524271
35319739,9,224,11,77,0,0,321,30.218068535825548,28.205128205128204
35320006,3,89,0,1,0,0,93,4.3010752688172005,1.1111111111111072
35320183,71,196,16,73,1,0,357,45.09803921568627,31.46853146853147
35320778,0,45,0,2,0,0,47,4.255319148936165,4.255319148936165
35320870,73,39,0,9,0,0,121,67.76859504132231,18.75
35320924,79,16,2,13,1,0,111,85.58558558558559,50
35320936,22,64,1,47,0,0,134,52.23880597014925,42.85714285714286
35321059,38,48,0,1,0,0,87,44.827586206896555,2.0408163265306145
35321679,0,114,1,1,6,0,122,6.5573770491803245,6.5573770491803245
35321709,10,81,2,15,3,0,111,27.027027027027028,19.8019801980198
35323135,40,22,5,2,1,0,70,68.57142857142857,26.66666666666667
35324954,13,44,2,3,7,0,69,36.23188405797102,21.42857142857143
35325512,1,42,2,2,0,0,47,10.63829787234043,8.695652173913048
35326367,7,82,3,49,0,0,141,41.843971631205676,38.80597014925373
35327694,226,69,7,109,0,0,411,83.21167883211679,62.70270270270271
35328844,2,94,3,6,0,0,105,10.476190476190473,8.737864077669899
35329265,10,67,1,2,2,0,82,18.292682926829272,6.944444444444442
35329319,7,33,0,1,0,0,41,19.512195121951216,2.941176470588236
35329770,8,135,1,3,0,0,147,8.163265306122447,2.877697841726623
35329859,66,47,4,12,0,0,129,63.565891472868216,25.396825396825395
35330401,389,274,20,158,2,1,844,67.53554502369667,39.78021978021978
35331351,11,48,3,0,0,0,62,22.580645161290324,5.882352941176472
35331570,18,146,0,1,1,1,167,12.574850299401197,2.0134228187919434
35331600,12,45,1,3,0,0,61,26.22950819672131,8.163265306122447
35331971,5,56,3,8,1,0,73,23.28767123287672,17.647058823529417
35333943,84,19,1,9,0,0,113,83.1858407079646,34.48275862068966
35334091,137,45,2,26,1,0,211,78.67298578199052,39.189189189189186
35334352,139,26,1,15,1,0,182,85.71428571428572,39.53488372093024
35334364,70,26,1,13,0,1,111,76.57657657657657,36.58536585365854
35335022,26,133,6,9,6,0,180,26.111111111111107,13.636363636363635
35335472,75,237,1,20,1,0,334,29.041916167664674,8.4942084942085
35335496,33,12,3,10,1,0,59,79.66101694915254,53.84615384615385
35335551,36,20,1,12,1,0,70,71.42857142857143,41.17647058823529
35335587,197,50,9,115,0,0,371,86.52291105121293,71.26436781609196
35335782,4,193,1,3,0,0,201,3.9800995024875663,2.030456852791873
35335794,57,5,1,5,0,0,68,92.64705882352942,54.54545454545454
35336579,115,474,276,495,6,4,1370,65.4014598540146,62.23107569721116
35336661,32,56,6,152,3,1,250,77.60000000000001,74.31192660550458
35336683,27,19,2,7,1,1,57,66.66666666666667,36.66666666666667
35337161,21,62,0,16,0,0,99,37.37373737373737,20.512820512820518
35337274,100,36,6,52,0,1,195,81.53846153846153,62.10526315789473
35337596,99,33,2,19,0,0,153,78.43137254901961,38.888888888888886
35337651,106,19,0,15,0,0,140,86.42857142857143,44.11764705882353
35337948,67,21,2,2,1,2,95,77.89473684210526,25
35338473,188,60,4,52,0,0,304,80.26315789473684,48.275862068965516
35338540,92,25,4,34,0,0,155,83.87096774193549,60.31746031746032
35340340,84,37,2,27,2,1,153,75.81699346405229,46.37681159420289
35341022,47,22,2,13,0,0,84,73.80952380952381,40.54054054054054
35342105,36,11,2,13,0,0,62,82.25806451612902,57.692307692307686
35342968,525,215,26,122,1,1,890,75.84269662921348,41.0958904109589
35342981,20,82,7,42,1,0,152,46.05263157894737,37.878787878787875
35343079,69,14,6,19,0,0,108,87.03703703703704,64.1025641025641
35343134,95,43,1,17,2,0,158,72.78481012658227,31.746031746031743
35343419,51,10,1,8,0,0,70,85.71428571428572,47.36842105263158
35343572,38,9,2,16,0,0,65,86.15384615384616,66.66666666666667
35343596,72,17,1,12,0,0,102,83.33333333333334,43.333333333333336
35343742,74,21,1,20,1,1,118,82.20338983050848,52.27272727272727
35344837,34,159,1,5,5,0,204,22.058823529411764,6.470588235294117
35346378,212,208,12,177,5,1,615,66.1788617886179,48.38709677419355
35346445,306,183,27,153,1,2,672,72.76785714285714,50
35346470,26,85,1,36,0,0,148,42.567567567567565,30.327868852459016
35346724,2,188,4,5,3,0,202,6.930693069306926,6.000000000000005
35346810,2,50,0,2,1,0,55,9.090909090909093,5.660377358490565
35347024,4,63,0,0,0,0,67,5.970149253731338,0
35347224,13,388,0,0,2,0,403,3.7220843672456594,0.512820512820511
35347309,26,13,1,20,0,0,60,78.33333333333333,61.76470588235294
35347450,34,27,3,16,0,0,80,66.25,41.30434782608695
35348934,46,8,2,12,0,0,68,88.23529411764706,63.63636363636363
35349324,3,48,0,9,0,0,60,19.999999999999996,15.789473684210531
35350000,72,15,1,10,1,0,99,84.84848484848484,44.44444444444444
35350126,43,11,1,8,1,0,64,82.8125,47.61904761904761
35350936,59,39,5,86,1,0,190,79.47368421052632,70.2290076335878
35351283,34,21,1,11,0,0,67,68.65671641791045,36.36363636363637
35351313,96,18,3,37,0,0,154,88.31168831168831,68.96551724137932
35351398,59,20,1,20,0,0,100,80,51.21951219512195
35351404,67,10,0,12,1,0,90,88.88888888888889,56.52173913043479
35351436,95,192,22,82,4,0,395,51.39240506329115,36
35352573,469,275,16,129,1,0,890,69.10112359550563,34.67933491686461
35352652,272,817,9,36,7,1,1142,28.458844133099824,6.09195402298851
35353152,81,22,8,51,1,0,163,86.50306748466258,73.17073170731707
35353188,13,36,10,32,1,0,92,60.86956521739131,54.43037974683544
35353279,46,43,3,7,0,0,99,56.56565656565656,18.867924528301884
35353280,155,129,7,29,0,0,320,59.68750000000001,21.818181818181813
35353309,103,16,1,37,1,0,158,89.87341772151899,70.9090909090909
35353474,52,20,1,7,1,0,81,75.30864197530865,31.034482758620683
35353486,85,37,2,14,1,1,140,73.57142857142858,32.72727272727273
35354454,19,22,5,18,1,0,65,66.15384615384615,52.17391304347826
35354685,52,435,50,351,3,0,891,51.178451178451176,48.15256257449344
35354715,100,651,75,622,0,0,1448,55.0414364640884,51.70623145400594
35354727,63,32,1,36,0,0,132,75.75757575757575,53.623188405797094
35355185,418,271,38,395,4,0,1126,75.93250444049734,61.72316384180792
35355562,58,29,3,8,0,0,98,70.40816326530613,27.500000000000004
35356566,11,99,16,110,2,0,238,58.40336134453781,56.38766519823788
35356591,127,140,23,254,2,3,549,74.4990892531876,66.82464454976304
35356612,432,497,66,969,8,3,1975,74.8354430379747,67.7900194426442
35356621,4,84,9,93,1,0,191,56.02094240837696,55.080213903743314
35356712,236,114,8,192,0,2,552,79.34782608695652,63.9240506329114
35356736,651,564,65,766,3,1,2050,72.48780487804878,59.685489635453905
35356748,13,80,4,85,0,0,182,56.043956043956044,52.662721893491124
35356759,1,208,23,249,1,0,482,56.84647302904564,56.75675675675676
35356761,266,357,61,419,2,1,1106,67.72151898734178,57.49999999999999
35356773,119,61,2,71,1,0,254,75.98425196850394,54.81481481481482
35356803,311,110,7,116,1,1,546,79.85347985347985,53.191489361702125
35356815,518,369,27,321,1,1,1237,70.16976556184316,48.67872044506258
35356852,108,568,51,544,6,7,1284,55.7632398753894,51.70068027210885
35357005,142,34,3,12,2,1,194,82.4742268041237,34.61538461538461
35357017,209,125,20,196,0,0,550,77.27272727272727,63.34310850439883
35357030,615,397,33,251,2,5,1303,69.53184957789715,42.29651162790697
35357066,111,66,7,20,0,0,204,67.64705882352942,29.032258064516125
35357085,143,117,5,23,0,0,288,59.375,19.310344827586214
35357091,372,526,18,233,0,3,1152,54.34027777777778,32.56410256410256
35357108,93,46,8,43,0,0,190,75.78947368421053,52.57731958762887
35357112,163,193,22,246,1,2,627,69.21850079744817,58.4051724137931
35357121,561,471,56,457,2,1,1548,69.57364341085271,52.27963525835866
35357133,64,18,2,43,0,0,127,85.8267716535433,71.42857142857143
35359993,102,493,104,812,4,1,1516,67.4802110817942,65.13437057991513
35360284,32,20,2,49,0,0,103,80.58252427184466,71.83098591549295
35360454,127,34,3,39,1,0,204,83.33333333333334,55.84415584415585
35361677,42,24,2,16,0,0,84,71.42857142857143,42.85714285714286
35362839,154,63,0,35,0,0,252,75,35.71428571428571
35362992,63,39,3,15,0,0,120,67.5,31.57894736842105
35363017,43,37,8,14,1,0,103,64.07766990291262,38.33333333333333
35363066,30,38,5,22,0,0,95,60,41.53846153846153
35363085,42,17,4,15,0,0,78,78.2051282051282,52.77777777777778
35363091,55,25,4,14,0,0,98,74.48979591836735,41.860465116279066
35363315,327,446,31,229,2,1,1036,56.949806949806955,37.09449929478138
35363595,25,139,3,2,4,0,173,19.653179190751445,6.081081081081086
35364435,149,173,13,97,1,2,435,60.229885057471265,39.51048951048951
35365592,18,147,2,4,5,0,176,16.47727272727273,6.9620253164556996
35365622,344,643,36,250,1,3,1277,49.64761158966328,31.082529474812436
35365695,20,56,1,7,3,0,87,35.63218390804598,16.417910447761198
35366353,15,64,2,4,0,0,85,24.705882352941178,8.571428571428575
35367722,408,81,1,5,1,0,496,83.66935483870968,7.954545454545459
35367734,291,273,3,12,2,0,581,53.012048192771076,5.862068965517242
35370575,11,42,0,0,0,0,53,20.75471698113207,0
35371439,64,60,1,26,1,0,152,60.526315789473685,31.818181818181824
35371488,41,50,9,9,0,0,109,54.12844036697248,26.470588235294112
35371981,1142,598,67,457,10,4,2278,73.74890254609306,47.359154929577464
35372092,45,148,3,10,1,0,207,28.502415458937204,8.64197530864198
35374283,63,91,3,18,1,0,176,48.29545454545454,19.469026548672563
35374957,35,76,2,63,0,0,176,56.81818181818181,46.09929078014184
35375724,38,25,0,12,21,0,96,73.95833333333333,56.896551724137936
35375780,10,74,14,81,0,0,179,58.659217877094974,56.213017751479285
35376243,40,10,0,8,3,0,61,83.60655737704919,52.38095238095239
35376322,8,54,0,8,1,0,71,23.943661971830988,14.28571428571429
35376942,50,90,6,28,0,0,174,48.275862068965516,27.419354838709676
35376966,34,15,5,14,1,0,69,78.26086956521739,57.14285714285714
35378720,75,18,2,12,0,0,107,83.17757009345794,43.75
35380805,10,47,15,57,0,0,129,63.565891472868216,60.504201680672274
35380829,92,43,0,30,0,0,165,73.93939393939394,41.0958904109589
35380908,5,46,3,35,1,0,90,48.88888888888889,45.88235294117647
35380970,5,28,3,25,0,0,61,54.0983606557377,50
35381007,31,15,4,23,0,0,73,79.45205479452055,64.28571428571428
35381019,12,81,7,35,0,0,135,40,34.14634146341463
35381044,106,97,8,60,0,0,271,64.20664206642066,41.21212121212121
35381073,2,61,0,3,5,0,71,14.084507042253524,11.594202898550721
35381081,284,104,18,152,0,0,558,81.36200716845879,62.04379562043796
35381111,226,455,53,395,5,1,1135,59.91189427312775,49.94499449944995
35381123,66,6,0,18,0,0,90,93.33333333333333,75
35381160,58,34,1,7,0,1,101,66.33663366336633,20.93023255813954
35382700,5,33,5,82,1,0,126,73.80952380952381,72.72727272727273
35383946,3,51,4,9,0,0,67,23.880597014925375,20.3125
35384409,104,134,1,0,0,1,240,44.166666666666664,1.4705882352941124
35384835,35,72,0,2,7,0,116,37.93103448275862,11.111111111111116
35385585,19,17,0,21,0,0,57,70.17543859649122,55.263157894736835
35385670,97,35,1,12,0,0,145,75.86206896551724,27.083333333333336
35385864,41,6,2,18,0,0,67,91.04477611940298,76.92307692307692
35387290,76,39,2,36,0,0,153,74.50980392156863,49.350649350649356
35387332,54,41,3,24,0,0,122,66.39344262295081,39.70588235294118
35387411,1034,308,38,294,1,2,1677,81.63387000596303,52.09953343701399
35388117,97,235,15,66,1,1,415,43.37349397590361,26.100628930817614
35388129,77,91,2,43,0,0,213,57.27699530516433,33.08823529411765
35388245,50,33,2,34,2,0,121,72.72727272727273,53.52112676056338
35388324,55,21,2,13,0,0,91,76.92307692307692,41.666666666666664
35388701,21,12,3,28,0,0,64,81.25,72.09302325581395
35388737,80,42,3,15,0,0,140,70,30.000000000000004
35388750,126,42,5,46,0,0,219,80.82191780821918,54.83870967741935
35388762,53,31,1,17,0,0,102,69.6078431372549,36.73469387755102
35389389,267,308,40,212,1,1,829,62.84680337756333,45.195729537366546
35390586,60,31,1,15,0,0,107,71.02803738317758,34.04255319148937
35390598,150,44,3,43,2,0,242,81.81818181818181,52.17391304347826
35390616,49,17,1,28,0,0,95,82.10526315789474,63.04347826086957
35390690,55,30,3,26,0,0,114,73.6842105263158,49.152542372881356
35391050,6,69,6,44,0,0,125,44.8,42.01680672268907
35391136,267,114,11,130,0,0,522,78.16091954022988,55.294117647058826
35391189,55,30,1,17,1,0,104,71.15384615384616,38.775510204081634
35391190,82,31,3,12,0,0,128,75.78125,32.608695652173914
35391207,76,37,0,13,0,0,126,70.63492063492063,26
35391220,63,22,8,35,0,0,128,82.8125,66.15384615384615
35391244,80,30,6,21,0,0,137,78.1021897810219,47.36842105263158
35391273,62,31,6,36,1,0,136,77.20588235294117,58.10810810810811
35391281,153,62,4,78,0,0,297,79.12457912457913,56.94444444444444
35391612,77,28,2,10,0,0,117,76.06837606837607,30.000000000000004
35391657,36,21,3,19,0,0,79,73.41772151898735,51.162790697674424
35391736,216,65,6,23,0,0,310,79.03225806451613,30.85106382978723
35391761,56,43,3,13,0,0,115,62.60869565217391,27.118644067796616
35391773,114,37,2,23,1,0,177,79.09604519774011,41.269841269841265
35391797,151,71,2,32,0,0,256,72.265625,32.38095238095238
35391840,33,23,1,9,1,0,67,65.67164179104478,32.35294117647059
35391918,65,56,7,39,3,0,170,67.05882352941177,46.666666666666664
35391992,97,33,2,26,0,0,158,79.11392405063292,45.90163934426229
35392315,15,55,2,5,2,0,79,30.379746835443033,14.0625
35392832,5,9,4,23,0,0,41,78.04878048780488,75
35392873,12,11,3,18,0,0,44,75,65.625
35392947,89,51,6,47,1,0,194,73.71134020618557,51.42857142857142
35393061,32,38,1,21,2,0,94,59.57446808510638,38.70967741935484
35393236,38,63,0,3,0,0,104,39.42307692307693,4.545454545454541
35393277,370,173,31,190,0,5,769,77.50325097529259,56.64160401002507
35393400,85,418,84,160,12,3,762,45.14435695538058,38.25701624815362
35393964,32,35,4,33,0,0,104,66.34615384615384,51.388888888888886
35395249,27,26,4,30,0,0,87,70.11494252873563,56.666666666666664
35396096,51,124,7,222,6,0,410,69.7560975609756,65.45961002785515
35396163,18,130,1,0,1,0,150,13.33333333333333,1.5151515151515138
35396539,8,126,8,85,0,0,227,44.49339207048458,42.465753424657535
35396588,116,234,22,158,1,2,533,56.09756097560976,43.88489208633094
35396692,332,526,39,369,4,1,1271,58.61526357199056,43.98296059637913
35396801,21,65,11,98,0,0,195,66.66666666666667,62.643678160919535
35397015,219,194,19,152,2,0,586,66.89419795221842,47.13896457765667
35397064,151,626,39,354,0,0,1170,46.495726495726494,38.56722276741904
35397088,10,87,15,110,0,0,222,60.810810810810814,58.96226415094339
35397131,109,226,23,178,4,1,541,58.225508317929766,47.68518518518518
35397271,241,411,46,363,1,1,1063,61.33584195672624,50
35397453,15,118,13,40,0,0,186,36.55913978494624,30.99415204678363
35397465,172,146,25,111,4,1,459,68.1917211328976,49.12891986062717
35397477,159,412,26,374,1,1,973,57.65673175745118,49.38574938574939
35397775,117,55,7,64,0,0,243,77.36625514403292,56.34920634920635
35398238,236,139,10,227,4,0,616,77.43506493506493,63.421052631578945
35398408,343,557,44,588,4,0,1536,63.73697916666667,53.31098072087175
35399197,38,120,2,6,14,1,181,33.70165745856354,16.083916083916083
35399474,92,61,7,58,1,0,219,72.14611872146119,51.96850393700787
35399516,262,102,12,114,3,1,494,79.35222672064776,56.03448275862068
35399681,86,44,6,57,2,0,195,77.435897435897445,59.63302752293578
35399693,252,144,8,137,2,0,543,73.48066298342542,50.51546391752577
35399700,412,491,55,617,0,1,1576,68.84517766497463,57.81786941580756
35399930,106,400,50,227,0,2,785,49.044585987261144,41.08983799705449
35400051,310,463,40,314,1,1,1129,58.99025686448185,43.46764346764347
35400063,43,604,24,172,11,0,854,29.274004683840747,25.52404438964242
35400075,211,506,76,419,5,0,1217,58.422350041084634,49.70178926441352
35400087,380,518,37,369,2,6,1312,60.518292682926834,44.4206008583691
35400099,194,159,10,117,0,0,480,66.875,44.40559440559441
35400324,403,409,43,161,1,1,1018,59.82318271119843,33.4959349593496
35401353,95,43,6,37,0,1,182,76.37362637362637,50.57471264367817
35402631,609,34,3,41,0,1,688,95.05813953488372,56.96202531645569
35402758,76,41,0,31,0,0,148,72.2972972972973,43.05555555555556
35403118,111,47,6,41,0,0,205,77.07317073170732,50
35403210,35,35,3,29,0,0,102,65.68627450980392,47.76119402985075
35404664,63,34,6,41,0,0,144,76.38888888888889,58.0246913580247
35404718,13,14,1,17,0,0,45,68.88888888888889,56.25
35405085,73,15,0,25,0,0,113,86.72566371681415,62.5
35405197,32,19,1,27,1,0,80,76.25,60.41666666666667
35405243,61,292,25,103,5,0,486,39.91769547325102,31.294117647058826
35405322,279,363,40,140,3,1,826,56.05326876513317,33.63802559414991
35406193,233,111,5,62,1,3,415,73.25301204819277,39.01098901098901
35406569,31,14,2,19,1,0,67,79.10447761194031,61.111111111111114
35407318,28,15,4,17,3,0,67,77.61194029850746,61.53846153846154
35407343,212,405,64,248,4,0,933,56.59163987138264,43.828016643550626
35407896,55,12,2,7,1,0,77,84.4155844155844,45.45454545454546
35407975,44,18,0,10,6,0,78,76.92307692307692,47.05882352941176
35408128,46,23,0,91,0,0,160,85.625,79.82456140350878
35408136,94,28,1,11,0,0,134,79.10447761194031,30.000000000000004
35408268,32,20,6,26,3,0,87,77.01149425287358,63.63636363636363
35408360,105,280,49,360,2,3,799,64.95619524405507,59.654178674351584
35408384,309,308,40,458,0,0,1115,72.37668161434978,61.78660049627791
35408463,238,503,29,538,3,0,1311,61.63234172387491,53.12208760484622
35408566,694,260,37,289,0,0,1280,79.6875,55.63139931740615
35408608,278,549,61,501,4,0,1393,60.588657573582196,50.762331838565025
35409169,446,793,48,349,3,2,1641,51.67580743449116,33.64016736401674
35409601,74,41,2,25,0,1,143,71.32867132867133,40.57971014492754
35409613,32,23,1,40,0,1,97,76.28865979381443,64.61538461538461
35409637,24,26,2,18,0,0,70,62.857142857142854,43.47826086956522
35410697,366,291,38,240,1,1,937,68.94343649946639,49.03677758318739
35410743,327,330,20,225,4,1,907,63.61631753031973,43.103448275862064
35411139,17,10,2,12,0,0,41,75.60975609756098,58.33333333333333
35411152,24,25,5,35,0,0,89,71.91011235955057,61.53846153846154
35411814,500,304,25,210,3,3,1045,70.9090909090909,44.220183486238525
35411875,88,196,17,74,1,0,376,47.87234042553191,31.944444444444443
35412173,287,368,44,326,1,1,1027,64.16747809152872,50.27027027027027
35412961,8,17,5,21,0,0,51,66.66666666666667,60.46511627906976
35412995,83,26,3,69,0,0,181,85.6353591160221,73.46938775510203
35413008,283,83,18,137,1,0,522,84.09961685823755,65.27196652719664
35413012,723,249,27,414,2,1,1416,82.41525423728814,64.06926406926408
35414025,109,15,2,11,0,0,137,89.05109489051095,46.42857142857143
35414074,159,93,8,86,1,1,348,73.27586206896552,50.79365079365079
35414098,29,17,3,14,1,0,64,73.4375,51.42857142857142
35414232,101,48,2,48,24,2,225,78.66666666666666,61.29032258064516
35414281,12,19,3,18,0,0,52,63.46153846153846,52.5
35414323,10,16,3,20,1,0,50,68,60
35414396,10,18,6,23,0,0,57,68.42105263157895,61.702127659574465
35414426,33,15,0,21,0,0,69,78.26086956521739,58.33333333333333
35414475,72,28,1,44,0,0,145,80.6896551724138,61.64383561643836
35414612,310,229,35,266,1,0,841,72.77051129607611,56.87382297551788
35414670,98,48,1,24,1,0,172,72.09302325581395,35.13513513513513
35414815,91,46,5,30,2,0,174,73.5632183908046,44.57831325301205
35414852,5,20,3,16,0,0,44,54.54545454545454,48.71794871794872
35414864,155,95,0,16,1,0,267,64.41947565543072,15.17857142857143
35415108,224,454,106,289,0,3,1076,57.80669144981412,46.713615023474176
35415376,294,290,38,348,6,0,976,70.28688524590163,57.47800586510263
35415388,438,262,25,269,4,0,998,73.74749498997997,53.214285714285715
35415397,145,485,58,387,4,0,1079,55.05097312326228,48.07280513918629
35415406,139,27,1,56,0,0,223,87.89237668161435,67.85714285714286
35415418,330,71,12,182,2,0,597,88.107202680067,73.40823970037454
35415443,348,569,69,424,19,2,1431,60.23759608665269,47.46075715604802
35416976,9,28,2,27,1,0,67,58.2089552238806,51.72413793103448
35417051,66,461,38,338,3,4,910,49.34065934065934,45.37914691943128
35417063,78,454,19,375,2,4,932,51.28755364806867,46.838407494145194
35417294,48,43,7,38,2,0,138,68.84057971014492,52.222222222222214
35417348,71,34,4,18,3,0,130,73.84615384615385,42.3728813559322
35417361,211,91,5,52,7,0,366,75.13661202185793,41.29032258064517
35417397,375,406,10,226,5,1,1023,60.312805474095796,37.34567901234568
35417440,119,379,68,736,0,0,1302,70.89093701996929,67.96280642434489
35417518,86,42,4,54,0,0,186,77.41935483870968,58.00000000000001
35418161,301,406,38,429,6,0,1180,65.59322033898304,53.811149032992034
35418213,99,606,45,547,5,1,1303,53.49194167306217,49.667774086378735
35418250,313,329,32,316,0,0,990,66.76767676767676,51.40324963072378
35418286,59,15,1,15,0,0,90,83.33333333333334,51.61290322580645
35418341,68,17,2,32,1,0,120,85.83333333333334,67.3076923076923
35418808,227,92,5,110,1,0,435,78.85057471264368,55.769230769230774
35419096,29,26,2,8,0,0,65,60,27.77777777777778
35419285,9,368,45,405,0,1,828,55.55555555555556,55.06715506715507
35419345,332,400,39,391,0,1,1163,65.60619088564059,51.86522262334536
35419357,958,320,44,387,1,4,1714,81.33022170361727,57.67195767195767
35419369,60,23,0,41,0,0,124,81.4516129032258,64.0625
35419394,174,164,19,232,2,0,591,72.25042301184433,60.671462829736214
35419436,353,424,52,436,0,0,1265,66.48221343873517,53.50877192982456
35419461,452,363,57,354,6,2,1234,70.5834683954619,53.58056265984654
35419588,17,373,29,115,3,5,542,31.18081180811808,28.952380952380953
35419746,94,361,43,426,1,2,927,61.05717367853289,56.66266506602642
35419801,273,370,38,289,1,0,971,61.89495365602471,46.99140401146131
35419977,171,412,49,242,0,1,875,52.91428571428571,41.47727272727273
35420050,28,56,4,21,0,0,109,48.62385321100917,30.864197530864203
35420451,18,119,1,0,1,0,139,14.388489208633093,1.6528925619834656
35420529,11,49,4,0,0,0,64,23.4375,7.547169811320753
35421352,3,128,0,2,7,0,140,8.571428571428575,6.569343065693434
35421571,11,22,6,13,0,0,52,57.692307692307686,46.34146341463414
35421595,9,92,2,4,2,0,109,15.596330275229352,7.9999999999999964
35421856,184,32,0,18,0,0,234,86.32478632478633,36
35422204,610,203,24,181,3,0,1021,80.11753183153772,50.60827250608273
35423609,316,154,1,8,1,0,480,67.91666666666667,6.0975609756097615
35424134,220,561,60,381,11,2,1235,54.5748987854251,44.729064039408875
35424161,171,590,41,323,3,2,1130,47.78761061946902,38.47758081334723
35424195,42,128,12,158,0,0,340,62.35294117647059,57.04697986577181
35427809,47,13,0,20,0,0,80,83.75,60.60606060606061
35427861,15,17,0,48,0,0,80,78.75,73.84615384615385
35428073,107,35,7,26,0,0,175,80,48.529411764705884
35428267,8,112,1,0,0,0,121,7.438016528925617,0.8849557522123908
35428279,51,10,2,2,0,0,65,84.61538461538461,28.57142857142857
35428693,51,41,1,21,0,0,114,64.03508771929825,34.92063492063492
35428700,108,18,0,34,0,0,160,88.75,65.38461538461539
35428711,20,40,3,21,1,0,85,52.94117647058824,38.46153846153846
35428759,11,107,1,3,9,0,131,18.3206106870229,10.833333333333329
35428848,209,244,34,264,4,2,757,67.76750330250991,55.47445255474452
35428851,285,245,24,211,0,0,765,67.97385620915033,48.958333333333336
35428863,6,16,2,23,0,1,48,66.66666666666667,61.904761904761905
35428875,16,14,5,19,0,0,54,74.07407407407408,63.1578947368421
35428905,479,531,51,274,4,2,1341,60.40268456375839,38.39907192575406
35428929,369,369,23,200,8,2,971,61.997940267765195,38.70431893687708
35428978,26,92,6,59,0,0,183,49.72677595628415,41.40127388535032
35428985,63,41,2,31,0,0,137,70.07299270072993,44.5945945945946
35429004,12,38,8,14,2,0,74,48.64864864864865,38.70967741935484
35429028,55,30,3,21,1,0,110,72.72727272727273,45.45454545454546
35429156,43,63,1,14,0,0,121,47.933884297520656,19.23076923076923
35429223,37,47,5,41,1,0,131,64.12213740458014,50
35429235,40,47,7,35,1,0,130,63.84615384615384,47.77777777777777
35429284,135,237,7,49,0,1,429,44.75524475524476,19.387755102040817
35429296,28,22,1,11,0,0,62,64.51612903225806,35.29411764705882
35429302,32,31,8,16,0,0,87,64.36781609195403,43.63636363636364
35429338,84,132,3,17,0,0,236,44.067796610169495,13.157894736842103
35429405,427,396,40,348,2,3,1216,67.4342105263158,49.80988593155894
35429569,119,176,14,21,0,0,330,46.666666666666664,16.58767772511849
35429570,80,189,11,38,1,0,319,40.75235109717868,20.920502092050206
35429612,331,294,1,1,2,0,629,53.25914149443561,1.342281879194629
35429624,19,42,0,3,0,0,64,34.375,6.666666666666665
35429703,29,57,20,25,0,0,131,56.48854961832062,44.11764705882353
35429831,144,52,0,0,2,0,198,73.73737373737373,3.703703703703709
35430377,24,126,6,10,1,0,167,24.55089820359282,11.888111888111885
35430742,129,9,2,17,0,0,157,94.26751592356688,67.85714285714286
35430754,2,60,0,0,2,0,64,6.25,3.2258064516129004
35430766,37,22,3,21,0,0,83,73.49397590361446,52.17391304347826
35431011,93,32,5,141,0,0,271,88.19188191881919,82.02247191011236
35431023,388,30,4,28,0,0,450,93.33333333333333,51.61290322580645
35431035,81,11,1,35,0,0,128,91.40625,76.59574468085107
35431059,68,64,1,29,0,0,162,60.49382716049383,31.914893617021278
35431459,60,634,13,29,2,0,738,14.092140921409213,6.4896755162241915
35431497,140,14,3,40,0,0,197,92.89340101522842,75.43859649122807
35431503,71,29,3,28,1,0,132,78.03030303030303,52.459016393442624
35431515,60,30,5,15,1,0,111,72.97297297297297,41.17647058823529
35431527,30,17,1,12,0,0,60,71.66666666666667,43.333333333333336
35431576,55,23,9,23,0,0,110,79.0909090909091,58.18181818181818
35431588,68,41,7,37,0,0,153,73.20261437908498,51.764705882352935
35431850,16,64,9,32,0,0,121,47.107438016528924,39.047619047619044
35431898,34,24,1,13,0,0,72,66.66666666666667,36.8421052631579
35432015,6,19,2,29,0,0,56,66.07142857142857,62
35432271,40,17,1,12,1,0,71,76.05633802816901,45.16129032258065
35432283,25,15,4,25,2,0,71,78.87323943661973,67.3913043478261
35432350,41,22,3,13,0,0,79,72.15189873417722,42.10526315789473
35432362,60,9,0,5,0,0,74,87.83783783783784,35.71428571428571
35432398,11,112,3,12,1,0,139,19.424460431654676,12.5
35432490,55,7,0,3,0,0,65,89.23076923076923,30.000000000000004
35432520,54,18,1,6,0,0,79,77.21518987341773,28.000000000000004
35432556,11,92,8,66,1,0,178,48.31460674157303,44.91017964071856
35432581,26,24,5,19,0,0,74,67.56756756756756,50
35432623,71,8,2,8,0,0,89,91.01123595505618,55.55555555555556
35432702,35,14,1,5,0,0,55,74.54545454545455,30.000000000000004
35432714,70,24,2,12,1,2,111,78.37837837837837,41.463414634146346
35432787,18,50,2,29,1,0,100,50,39.02439024390244
35432854,91,58,6,18,0,0,173,66.47398843930637,29.268292682926834
35432878,94,37,2,53,0,0,186,80.10752688172043,59.78260869565217
35432885,37,22,3,16,0,0,78,71.7948717948718,46.34146341463414
35432891,59,7,2,10,1,0,79,91.13924050632912,65
35432912,42,40,4,51,0,0,137,70.8029197080292,57.89473684210527
35432921,70,28,1,24,0,0,123,77.23577235772358,47.16981132075472
35432933,38,91,11,65,0,0,205,55.60975609756098,45.50898203592815
35432945,38,11,1,17,0,0,67,83.5820895522388,62.06896551724138
35432969,63,18,0,17,1,0,99,81.81818181818181,50
35432970,22,22,2,23,1,0,70,68.57142857142857,54.16666666666667
35432982,99,95,1,25,0,0,220,56.81818181818181,21.487603305785118
35433020,68,26,0,13,0,0,107,75.70093457943925,33.333333333333336
35433032,91,31,3,24,0,1,150,79.33333333333333,47.45762711864406
35433044,97,45,0,6,0,0,148,69.5945945945946,11.764705882352944
35433068,49,27,2,26,0,0,104,74.03846153846155,50.90909090909091
35433081,16,27,1,11,0,0,55,50.90909090909091,30.76923076923077
35433093,89,28,2,20,0,0,139,79.85611510791367,43.99999999999999
35433100,74,40,1,43,0,0,158,74.68354430379746,52.38095238095239
35433111,77,40,13,95,0,0,225,82.22222222222221,72.97297297297297
35433123,36,50,6,34,0,0,126,60.31746031746032,44.44444444444444
35433135,31,125,1,1,1,0,159,21.383647798742132,2.34375
35433147,129,21,0,31,0,0,181,88.39779005524862,59.61538461538461
35433159,98,33,1,11,0,0,143,76.92307692307692,26.66666666666667
35433329,13,12,2,24,0,0,51,76.47058823529412,68.42105263157895
35433354,0,86,2,15,0,0,103,16.504854368932044,16.504854368932044
35433366,61,11,4,32,0,1,109,89.90825688073394,77.08333333333334
35433378,47,7,0,18,0,0,72,90.27777777777779,72
35433408,49,18,0,9,1,0,77,76.62337662337663,35.71428571428571
35433482,418,344,32,233,1,1,1029,66.56948493683188,43.698854337152206
35433500,13,46,0,10,0,0,69,33.333333333333336,17.85714285714286
35433524,32,35,0,1,1,0,69,49.27536231884058,5.405405405405405
35433536,10,39,2,2,1,0,54,27.77777777777778,11.363636363636365
35433603,91,26,7,31,0,1,156,83.33333333333334,60
35433615,195,402,49,295,2,0,943,57.37009544008483,46.256684491978604
35433664,133,189,33,195,3,0,553,65.82278481012658,55.00000000000001
35433718,128,552,61,423,6,1,1171,52.86080273270709,47.07574304889741
35433731,47,16,2,20,0,0,85,81.17647058823529,57.89473684210527
35433810,19,36,0,1,0,0,56,35.71428571428571,2.7027027027026973
35433822,114,38,3,42,0,0,197,80.71065989847716,54.216867469879524
35433846,275,503,35,183,9,2,1007,50.04965243296922,31.284153005464475
35433858,360,441,29,151,5,0,986,55.2738336713996,29.552715654952078
35433925,16,231,30,266,0,0,543,57.4585635359116,56.166982922201136
35433937,51,13,1,14,1,0,80,83.75,55.172413793103445
35434012,107,26,2,12,0,0,147,82.31292517006803,35
35434085,544,429,26,511,1,2,1513,71.64573694646398,55.72755417956656
35434097,475,231,23,215,1,0,945,75.55555555555556,50.851063829787236
35434103,63,425,39,235,2,0,764,44.3717277486911,39.37232524964337
35434115,106,120,9,173,0,2,410,70.73170731707317,60.526315789473685
35434127,241,104,14,169,0,0,528,80.3030303030303,63.76306620209059
35434140,55,23,3,14,0,0,95,75.78947368421053,42.50000000000001
35434152,281,278,31,286,7,1,884,68.55203619909503,53.8971807628524
35434231,87,47,8,105,0,0,247,80.97165991902834,70.625
35434243,49,16,2,7,0,0,74,78.37837837837837,36
35434279,45,24,9,20,0,1,99,75.75757575757575,55.55555555555556
35434292,412,151,8,108,0,1,680,77.79411764705883,43.656716417910445
35434449,8,38,2,13,0,0,61,37.704918032786885,28.301886792452834
35434516,4,397,2,4,12,0,419,5.250596658711215,4.337349397590362
35434528,45,20,2,26,1,0,94,78.72340425531915,59.183673469387756
35434632,175,426,27,160,4,2,794,46.34760705289672,31.179321486268176
35434681,7,65,0,26,0,0,98,33.673469387755105,28.57142857142857
35434723,7,44,0,7,1,0,59,25.423728813559322,15.384615384615385
35434735,5,51,2,0,3,0,61,16.393442622950815,8.92857142857143
35434747,9,66,1,0,0,0,76,13.157894736842103,1.4925373134328401
35434759,66,104,1,17,0,0,188,44.680851063829785,14.754098360655743
35434772,192,104,5,107,2,0,410,74.63414634146342,52.293577981651374
35434826,199,20,1,23,0,0,243,91.76954732510289,54.54545454545454
35434978,106,40,6,32,2,1,187,78.6096256684492,50.617283950617285
35434991,81,37,3,19,5,0,145,74.48275862068965,42.1875
35435077,59,40,2,19,1,0,121,66.94214876033058,35.483870967741936
35435120,70,72,5,28,0,0,175,58.857142857142854,31.428571428571427
35435156,27,36,8,42,0,0,113,68.14159292035397,58.13953488372092
35435181,25,53,12,41,0,0,131,59.541984732824424,50
35435223,27,34,2,5,0,0,68,50,17.07317073170732
35435235,42,13,1,15,0,0,71,81.69014084507043,55.172413793103445
35435284,82,13,2,19,3,0,119,89.07563025210084,64.86486486486487
35435338,1,45,1,0,3,0,50,9.999999999999998,8.163265306122447
35435348,109,29,1,17,2,0,158,81.64556962025317,40.816326530612244
35435405,69,28,0,21,0,0,118,76.27118644067797,42.85714285714286
35435570,115,20,6,26,1,0,168,88.09523809523809,62.264150943396224
35435582,54,12,1,13,0,0,80,85,53.84615384615385
35435594,20,26,3,21,0,2,72,63.888888888888886,50
35435600,5,32,2,23,0,0,62,48.38709677419355,43.85964912280702
35435673,23,45,4,31,0,0,103,56.310679611650485,43.75
35435685,68,30,4,19,0,0,121,75.20661157024793,43.39622641509434
35435818,81,133,8,17,2,1,242,45.041322314049594,17.391304347826086
35435824,73,28,5,34,0,0,140,80,58.2089552238806
35437050,323,269,22,184,0,1,799,66.33291614518147,43.48739495798319
35437773,29,22,0,19,0,0,70,68.57142857142857,46.34146341463414
35437785,35,19,1,11,1,0,67,71.64179104477613,40.625
35437840,71,53,6,84,0,0,214,75.23364485981308,62.93706293706294
35438005,1,92,2,5,2,0,102,9.80392156862745,8.910891089108908
35438017,31,13,1,6,1,0,52,75,38.095238095238095
35438042,18,90,12,63,0,0,183,50.81967213114754,45.45454545454546
35438054,277,224,31,309,1,0,842,73.39667458432304,60.35398230088496
35438112,377,450,65,412,1,2,1307,65.5700076511094,51.61290322580645
35438170,484,360,8,52,3,1,908,60.352422907488986,15.094339622641506
35438236,68,17,1,21,0,0,107,84.11214953271028,56.41025641025641
35438248,100,17,6,15,1,0,139,87.76978417266187,56.41025641025641
35438285,208,437,40,155,4,3,847,48.40613931523022,31.61189358372457
35438315,152,378,9,32,6,0,577,34.48873483535528,11.058823529411764
35438340,46,35,6,17,1,0,105,66.66666666666667,40.67796610169492
35438364,53,15,1,18,0,0,87,82.75862068965517,55.88235294117647
35438376,32,14,3,43,0,0,92,84.78260869565217,76.66666666666666
35438388,60,25,5,48,1,0,139,82.01438848920863,68.35443037974683
35438397,33,17,0,25,0,0,75,77.33333333333333,59.523809523809526
35438418,319,327,35,173,4,1,859,61.93247962747381,39.44444444444445
35438424,310,396,47,341,4,5,1103,64.09791477787851,50.06305170239597
35438467,69,20,0,13,0,0,102,80.3921568627451,39.39393939393939
35438480,3,596,64,311,3,2,979,39.12155260469867,38.934426229508205
35438522,37,12,2,12,0,0,63,80.95238095238095,53.84615384615385
35438534,28,37,0,13,0,0,78,52.56410256410257,26
35438613,74,9,7,18,0,0,108,91.66666666666666,73.52941176470588
35438662,37,58,2,5,0,0,102,43.13725490196079,10.769230769230765
35438686,11,60,6,61,0,0,138,56.52173913043479,52.75590551181102
35438698,3,60,12,67,0,0,142,57.74647887323944,56.83453237410072
35438820,207,253,32,106,4,0,602,57.973421926910305,35.949367088607595
35439083,32,281,48,184,2,3,550,48.909090909090914,45.75289575289575
35439101,90,59,3,35,0,0,187,68.44919786096257,39.175257731958766
35439125,64,31,6,27,1,2,131,76.33587786259541,53.73134328358209
35439186,117,122,19,66,1,0,325,62.46153846153846,41.34615384615385
35439216,362,454,24,170,14,4,1028,55.83657587548638,31.831831831831835
35439265,133,16,1,9,0,0,159,89.937106918239,38.46153846153846
35439277,27,29,12,21,0,0,89,67.41573033707866,53.2258064516129
35439289,41,3,0,1,0,0,45,93.33333333333333,25
35439356,64,110,6,19,0,0,199,44.72361809045226,18.518518518518523
35439447,10,508,54,302,1,0,875,41.94285714285715,41.27167630057803
35439745,64,32,0,17,0,0,113,71.68141592920354,34.693877551020414
35440024,264,367,60,415,1,0,1107,66.84733514001806,56.4650059311981
35440528,27,153,2,3,6,0,191,19.895287958115183,6.707317073170726
35440620,176,188,32,144,3,0,543,65.37753222836096,48.77384196185286
35440681,18,41,0,1,1,0,61,32.786885245901644,4.651162790697672
35440735,19,36,2,11,0,0,68,47.05882352941176,26.530612244897956
35440802,33,76,2,25,0,0,136,44.11764705882353,26.21359223300971
35440848,162,91,1,6,3,0,263,65.39923954372624,9.9009900990099
35440930,92,26,2,22,1,0,143,81.81818181818181,49.01960784313726
35440954,116,17,5,5,1,0,144,88.19444444444444,39.28571428571429
35441120,55,51,6,31,0,0,143,64.33566433566433,42.04545454545454
35441168,21,23,1,25,0,0,70,67.14285714285715,53.06122448979591
35441193,35,16,4,14,0,0,69,76.81159420289855,52.94117647058824
35441200,30,22,8,17,1,1,79,72.15189873417722,55.10204081632652
35441211,21,108,2,10,1,0,142,23.943661971830988,10.743801652892559
35441223,52,21,4,32,0,0,109,80.73394495412845,63.1578947368421
35441296,76,39,1,35,0,0,151,74.17218543046357,48
35441314,78,23,2,52,0,0,155,85.16129032258064,70.12987012987013
35441348,2,52,4,3,0,0,61,14.754098360655743,11.864406779661019
35441491,92,27,0,14,0,0,133,79.69924812030075,34.14634146341463
35441512,80,17,3,28,0,1,129,86.82170542635659,65.3061224489796
35441600,90,77,4,172,1,0,344,77.61627906976744,69.68503937007874
35441659,32,9,2,25,8,0,76,88.1578947368421,79.54545454545455
35441661,36,18,3,21,0,1,79,77.21518987341773,58.13953488372092
35441739,64,207,51,1,4,0,327,36.69724770642202,21.292775665399244
35441740,1,74,1,8,0,0,84,11.904761904761907,10.843373493975905
35442033,59,29,2,24,0,0,114,74.56140350877193,47.27272727272728
35442045,44,15,2,39,0,0,100,85,73.21428571428572
35442161,67,28,2,41,0,0,138,79.71014492753623,60.56338028169015
35442173,63,26,4,11,2,0,106,75.47169811320755,39.53488372093024
35442343,323,85,1,49,3,3,464,81.68103448275862,39.71631205673759
35442379,20,215,0,0,0,0,235,8.510638297872342,0
35442392,69,361,15,26,4,0,475,24,11.083743842364536
35442495,18,119,4,13,2,0,156,23.717948717948723,13.768115942028981
35442604,67,118,3,31,1,0,220,46.36363636363636,22.87581699346405
35442653,124,27,4,29,2,0,186,85.48387096774194,56.4516129032258
35442665,7,50,3,1,0,0,61,18.032786885245898,7.4074074074074066
35442719,17,22,3,31,0,1,74,70.27027027027026,61.40350877192983
35442811,12,15,2,17,0,0,46,67.3913043478261,55.88235294117647
35442823,64,21,7,42,1,0,135,84.44444444444444,70.4225352112676
35442835,154,65,11,81,1,0,312,79.16666666666666,58.86075949367089
35442902,59,158,6,29,1,0,253,37.549407114624515,18.556701030927837
35442926,82,48,0,48,2,0,180,73.33333333333334,51.02040816326531
35443189,9,50,3,11,0,0,73,31.506849315068497,21.875
35443190,0,59,0,0,2,0,61,3.2786885245901676,3.2786885245901676
35443219,162,316,19,119,2,0,618,48.8673139158576,30.701754385964907
35443220,420,72,5,125,1,2,625,88.48,64.8780487804878
35443281,55,19,0,38,1,0,113,83.1858407079646,67.24137931034483
35443293,56,33,1,19,0,0,109,69.72477064220183,37.735849056603776
35443300,37,20,2,21,0,0,80,75,53.48837209302326
35443323,42,22,1,20,0,0,85,74.11764705882354,48.837209302325576
35443335,23,21,2,13,1,0,60,65,43.24324324324324
35443448,94,14,2,39,1,0,150,90.66666666666666,75
35443487,49,23,4,19,0,0,95,75.78947368421053,50
35443517,57,88,0,0,0,0,145,39.310344827586206,0
35443621,27,59,3,25,0,1,115,48.69565217391304,32.95454545454546
35443669,33,13,1,21,0,0,68,80.88235294117648,62.857142857142854
35443670,30,18,4,17,0,0,69,73.91304347826086,53.84615384615385
35443694,1,37,2,1,0,0,41,9.756097560975608,7.499999999999996
35443700,65,15,2,20,0,0,102,85.29411764705883,59.45945945945945
35443736,26,16,3,16,0,0,61,73.77049180327869,54.28571428571429
35443761,23,9,5,49,1,1,88,89.77272727272727,86.15384615384616
35443840,75,40,2,30,1,0,148,72.97297297297297,45.205479452054796
35443864,47,20,3,19,0,0,89,77.52808988764045,52.38095238095239
35443876,58,20,2,6,0,0,86,76.74418604651163,28.57142857142857
35443888,75,15,1,18,0,0,109,86.23853211009174,55.88235294117647
35443897,50,24,1,21,0,0,96,75,47.82608695652174
35443918,54,14,2,27,0,0,97,85.56701030927836,67.44186046511628
35443924,20,148,7,8,1,0,184,19.565217391304344,9.756097560975608
35444005,26,27,4,9,1,0,67,59.70149253731343,34.14634146341463
35444042,34,56,3,16,0,0,109,48.62385321100917,25.33333333333333
35444121,546,261,18,183,3,1,1012,74.2094861660079,43.99141630901288
35444133,241,242,21,198,1,1,704,65.625,47.73218142548596
35444157,3,93,0,1,4,0,101,7.920792079207917,5.102040816326525
35444169,3,100,1,20,0,0,124,19.354838709677423,17.355371900826444
35444182,76,4,0,0,0,0,80,95,0
35444327,31,51,3,17,1,0,103,50.48543689320388,29.166666666666664
35444364,3,95,1,1,1,0,101,5.940594059405946,3.0612244897959218
35444418,84,18,2,2,0,0,106,83.01886792452831,18.181818181818176
35444479,71,147,12,25,4,0,259,43.24324324324324,21.808510638297875
35444480,16,86,1,2,8,0,113,23.893805309734518,11.340206185567014
35444509,46,55,3,19,0,0,123,55.28455284552846,28.57142857142857
35444522,26,111,0,2,0,0,139,20.143884892086326,1.7699115044247815
35444534,72,36,1,15,0,0,124,70.96774193548387,30.76923076923077
35444625,49,43,6,87,1,0,186,76.88172043010752,68.61313868613139
35444637,21,19,6,25,1,0,72,73.61111111111111,62.745098039215684
35444741,63,35,1,39,0,0,138,74.63768115942028,53.333333333333336
35444753,84,26,1,35,0,0,146,82.1917808219178,58.06451612903225
35444765,53,28,3,12,2,0,98,71.42857142857143,37.77777777777778
35444777,95,29,13,8,2,0,147,80.27210884353741,44.230769230769226
35444790,46,18,3,13,0,0,80,77.5,47.05882352941176
35444819,3,162,2,0,0,0,167,2.9940119760479056,1.2195121951219523
35444893,34,25,5,24,0,0,88,71.59090909090908,53.703703703703695
35444923,88,46,2,53,4,0,193,76.16580310880829,56.19047619047619
35444935,297,36,5,35,0,0,373,90.3485254691689,52.63157894736843
35444947,77,10,1,12,0,0,100,90,56.52173913043479
35445009,52,12,4,15,0,0,83,85.54216867469879,61.29032258064516
35445034,62,16,0,33,0,1,112,85.71428571428572,68
35445058,27,23,2,13,0,0,65,64.61538461538461,39.473684210526315
35445061,57,15,0,24,0,0,96,84.375,61.53846153846154
35445083,37,22,1,16,3,1,80,72.5,48.837209302325576
35445113,5,74,1,1,0,0,81,8.64197530864198,2.631578947368418
35445162,49,67,10,22,2,0,150,55.333333333333336,33.66336633663366
35445204,73,11,0,0,0,0,84,86.90476190476191,0
35445241,41,29,6,212,0,1,289,89.96539792387543,88.30645161290323
35445332,191,526,3,3,13,0,736,28.532608695652172,3.4862385321100864
35445373,55,27,3,21,0,0,106,74.52830188679245,47.05882352941176
35445484,44,71,0,3,0,0,118,39.83050847457628,4.054054054054057
35445496,7,90,0,1,0,0,98,8.163265306122447,1.098901098901095
35445502,212,581,32,314,0,4,1143,49.16885389326334,37.59398496240601
35445526,611,342,42,299,0,0,1294,73.57032457496135,49.92679355783309
35445548,497,398,38,279,4,0,1216,67.26973684210526,44.645340751043115
35445563,63,46,4,36,0,0,149,69.12751677852349,46.51162790697675
35445630,22,92,1,8,4,0,127,27.55905511811023,12.380952380952381
35445859,3,54,0,1,3,0,61,11.475409836065575,6.896551724137934
35445885,82,192,14,189,0,1,478,59.83263598326361,51.515151515151516
35445988,88,13,0,20,0,0,121,89.25619834710744,60.60606060606061
35446117,47,15,1,9,0,0,72,79.16666666666666,40
35446129,28,16,2,25,0,1,72,77.77777777777779,63.63636363636363
35446166,49,40,3,17,0,0,109,63.30275229357798,33.333333333333336
35446440,38,58,2,27,0,1,126,53.968253968253975,34.09090909090909
35446695,359,448,40,214,8,2,1071,58.16993464052287,37.07865168539326
35446701,161,42,5,25,2,0,235,82.12765957446808,43.24324324324324
35446750,51,21,4,26,3,0,105,80,61.111111111111114
35446762,30,28,3,14,0,0,75,62.66666666666667,37.77777777777778
35446865,381,128,18,182,2,0,711,81.99718706047821,61.212121212121204
35446932,28,54,10,18,1,0,111,51.35135135135135,34.93975903614458
35447031,247,230,14,124,0,0,615,62.601626016260155,37.5
35447134,35,21,1,17,1,0,75,72,47.5
35447146,4,76,0,0,0,0,80,5.000000000000004,0
35447328,2,76,1,1,0,0,80,5.000000000000004,2.564102564102566
35447663,356,538,40,441,2,5,1382,61.07091172214183,47.563352826510716
35447766,193,97,13,133,1,0,437,77.80320366132723,60.24590163934427
35448060,124,453,34,130,7,2,750,39.6,27.635782747603834
35448151,34,55,10,77,0,0,176,68.75,61.26760563380282
35448163,95,29,8,30,0,0,162,82.09876543209876,56.71641791044777
35448291,6,22,2,15,1,0,46,52.17391304347826,44.99999999999999
35448308,111,23,2,21,1,0,158,85.44303797468355,51.06382978723405
35448369,266,621,19,81,6,0,993,37.46223564954683,14.580467675378262
35448459,173,54,3,78,0,2,310,82.58064516129032,60.58394160583942
35448783,38,94,2,1,0,0,135,30.37037037037037,3.0927835051546393
35449015,21,66,0,4,0,0,91,27.472527472527474,5.714285714285716
35449040,67,50,2,34,8,0,161,68.944099378882,46.808510638297875
35449179,13,85,2,15,19,0,134,36.56716417910447,29.75206611570248
35449477,392,130,19,54,1,1,597,78.22445561139028,36.58536585365854
35449490,2,39,0,0,0,0,41,4.878048780487809,0
35449581,9,142,1,2,1,0,155,8.387096774193548,2.73972602739726
35449660,41,32,5,21,0,0,99,67.67676767676767,44.827586206896555
35449672,2,165,3,31,5,0,206,19.902912621359224,19.11764705882353
35449726,28,31,3,17,0,0,79,60.75949367088608,39.21568627450981
35449738,49,105,0,9,1,0,164,35.97560975609756,8.695652173913048
35449748,515,518,7,39,4,2,1085,52.25806451612903,9.122807017543854
35449775,34,15,6,20,1,0,76,80.26315789473684,64.28571428571428
35449799,48,16,5,25,0,0,94,82.97872340425532,65.21739130434783
35449805,34,17,2,14,1,0,68,75,50
35449830,92,23,1,29,1,0,146,84.24657534246576,57.407407407407405
35450085,1,78,0,0,0,0,79,1.2658227848101222,0
35450108,48,16,3,13,0,0,80,80,50
35450170,15,29,3,5,1,0,53,45.28301886792453,23.684210526315784
35450182,31,53,4,7,0,0,95,44.21052631578948,17.1875
35450200,19,22,5,29,0,0,75,70.66666666666667,60.71428571428572
35450248,29,131,4,7,1,0,172,23.83720930232558,8.391608391608397
35450303,28,16,3,19,0,0,66,75.75757575757575,57.89473684210527
35450534,56,39,4,49,0,0,148,73.64864864864865,57.608695652173914
35450625,20,69,4,18,0,0,111,37.83783783783784,24.17582417582418
35450637,59,7,0,0,0,0,66,89.39393939393939,0
35450807,3,44,0,6,0,0,53,16.981132075471695,12
35450935,188,296,12,20,12,0,528,43.939393939393945,12.941176470588234
35450972,28,40,0,4,0,0,72,44.44444444444444,9.090909090909093
35451046,8,32,0,0,1,0,41,21.95121951219512,3.0303030303030276
35452014,84,33,3,40,0,0,160,79.375,56.57894736842105
35452221,58,44,1,36,0,0,139,68.34532374100719,45.67901234567901
35452233,0,47,0,0,0,0,47,0,0
35452543,78,133,4,21,1,0,237,43.881856540084385,16.35220125786163
35453171,113,17,5,16,0,0,151,88.74172185430463,55.263157894736835
35454382,44,10,3,10,0,0,67,85.07462686567165,56.52173913043479
35454734,46,12,8,8,0,0,74,83.78378378378379,57.14285714285714
35455131,61,11,0,19,0,0,91,87.91208791208791,63.33333333333333
35455209,72,24,3,71,1,0,171,85.96491228070175,75.75757575757575
35455313,172,27,0,0,1,0,200,86.5,3.57142857142857
35455374,354,274,29,284,2,0,943,70.94379639448569,53.4804753820034
35455386,195,331,46,117,1,1,691,52.098408104196814,33.266129032258064
35455416,105,187,34,154,3,0,483,61.28364389233955,50.52910052910053
35455428,135,154,11,83,0,0,383,59.7911227154047,37.903225806451616
35455436,87,204,13,125,2,1,432,52.77777777777778,40.869565217391305
35455441,54,72,11,57,0,0,194,62.88659793814433,48.57142857142858
35455465,114,220,18,140,1,0,493,55.37525354969575,41.95250659630607
35455477,113,121,10,108,0,0,352,65.625,49.372384937238486
35455490,239,387,29,197,4,4,860,55.00000000000001,37.68115942028986
35455507,37,66,3,51,0,0,157,57.961783439490446,44.99999999999999
35455519,98,132,11,74,0,1,316,58.22784810126582,39.449541284403665
35455520,37,51,2,53,0,0,143,64.33566433566433,51.886792452830186
35455532,226,347,23,150,2,0,748,53.6096256684492,33.52490421455939
35455544,119,134,20,144,0,0,417,67.86570743405275,55.033557046979865
35455556,68,88,24,74,0,0,254,65.35433070866141,52.68817204301075
35455573,94,266,13,174,0,0,547,51.37111517367459,41.280353200883
35455581,115,110,4,53,2,0,284,61.26760563380282,34.9112426035503
35455593,304,332,39,233,6,0,914,63.6761487964989,45.57377049180328
35455600,157,149,7,112,0,0,425,64.94117647058823,44.40298507462687
35455611,101,151,13,121,1,1,388,61.08247422680413,47.386759581881535
35455623,165,180,18,212,0,1,576,68.75,56.20437956204379
35455659,149,269,38,195,0,5,656,58.993902439024396,46.94280078895463
35455660,106,57,5,65,2,0,235,75.74468085106383,55.81395348837209
35455672,80,204,12,80,0,0,376,45.74468085106383,31.081081081081084
35455684,95,94,8,116,3,2,318,70.44025157232706,57.847533632286996
35455696,184,165,12,169,5,0,535,69.1588785046729,52.991452991452995
35455702,153,302,26,210,0,1,692,56.358381502890175,43.970315398886825
35455714,300,249,30,117,3,2,701,64.47931526390872,37.905236907730675
35455726,240,195,17,216,0,0,668,70.80838323353294,54.4392523364486
35455751,153,215,34,191,0,0,593,63.74367622259696,51.13636363636363
35455775,134,130,6,156,1,0,427,69.55503512880561,55.63139931740615
35455787,209,327,22,134,2,0,694,52.881844380403464,32.577319587628864
35455799,116,147,25,141,2,0,431,65.89327146171694,53.333333333333336
35455805,160,177,28,205,2,0,572,69.05594405594407,57.038834951456316
35455817,218,213,27,166,1,2,627,66.02870813397129,47.92176039119804
35455829,144,173,33,156,0,0,506,65.81027667984189,52.20994475138121
35455830,274,362,42,308,1,0,987,63.32320162107396,49.228611500701255
35455854,16,14,3,12,0,0,45,68.88888888888889,51.72413793103448
35455866,84,137,23,194,0,1,439,68.79271070615034,61.40845070422536
35455885,135,187,29,324,1,2,678,72.4188790560472,65.56169429097606
35455891,128,183,18,66,0,0,395,53.67088607594936,31.46067415730337
35455908,540,514,58,449,1,9,1571,67.28198599618078,50.14548981571289
35455912,235,245,16,100,1,1,598,59.03010033444816,32.5068870523416
35455921,35,61,3,54,0,0,153,60.130718954248366,48.30508474576271
35455933,182,222,3,99,1,1,508,56.2992125984252,31.90184049079755
35456147,58,23,3,15,0,0,99,76.76767676767678,43.90243902439024
35456159,36,42,17,36,0,0,131,67.93893129770993,55.78947368421052
35456196,297,163,9,132,1,0,602,72.92358803986711,46.557377049180324
35456342,3,102,0,0,0,0,105,2.857142857142858,0
35456597,66,48,8,17,0,0,139,65.46762589928056,34.24657534246576
35456697,134,25,0,0,0,0,159,84.27672955974843,0
35456706,8,29,0,8,0,0,45,35.55555555555555,21.62162162162162
35456731,157,548,3,24,66,0,798,31.328320802005017,14.508580343213728
35456834,22,63,8,56,0,0,149,57.71812080536913,50.39370078740157
35456871,23,29,0,0,0,0,52,44.230769230769226,0
35456883,2,36,2,2,0,0,42,14.28571428571429,9.999999999999998
35456895,3,35,1,4,2,0,45,22.22222222222222,16.666666666666664
35456901,0,95,0,0,0,0,95,0,0
35456913,9,68,3,12,0,0,92,26.086956521739136,18.07228915662651
35456949,37,6,3,6,1,0,53,88.67924528301887,62.5
35456962,8,32,0,2,0,0,42,23.809523809523814,5.882352941176472
35456974,0,80,0,0,3,0,83,3.6144578313253017,3.6144578313253017
35457085,32,21,3,9,0,1,66,68.18181818181819,38.23529411764706
35457103,11,154,6,164,1,0,336,54.16666666666667,52.61538461538462
35457176,47,21,0,7,0,0,75,72,25
35457206,32,262,4,16,12,0,326,19.631901840490794,10.8843537414966
35457224,50,42,4,39,1,0,136,69.11764705882352,51.162790697674424
35457243,680,508,62,324,4,3,1581,67.86843769765972,43.61820199778025
35457450,119,142,18,51,1,0,331,57.09969788519638,33.01886792452831
35457498,0,90,1,3,3,0,97,7.216494845360821,7.216494845360821
35457577,95,81,10,53,1,0,240,66.25,44.13793103448276
35457589,149,31,4,25,1,0,210,85.23809523809524,49.18032786885246
35457700,11,78,3,20,1,0,113,30.973451327433633,23.529411764705888
35457759,34,6,1,2,0,0,43,86.04651162790698,33.333333333333336
35457905,25,21,6,33,0,0,85,75.29411764705883,65
35457930,3,54,1,6,0,0,64,15.625,11.475409836065575
35458041,35,28,1,49,0,0,113,75.2212389380531,64.1025641025641
35458272,168,349,26,228,3,1,775,54.96774193548387,42.50411861614497
35458296,44,180,7,47,1,0,279,35.483870967741936,23.404255319148938
35458314,18,47,5,20,0,0,90,47.77777777777777,34.72222222222222
35458351,8,13,1,20,0,0,42,69.04761904761905,61.76470588235294
35458399,50,169,6,66,2,3,296,42.9054054054054,31.300813008130078
35460631,99,19,12,50,0,0,180,89.44444444444444,76.54320987654322
35460655,15,22,1,18,0,0,56,60.71428571428572,46.34146341463414
35460679,2,45,0,3,8,0,58,22.413793103448278,19.64285714285714
35460734,82,42,3,25,1,0,153,72.54901960784314,40.845070422535215
35460761,6,78,1,11,0,0,96,18.75,13.33333333333333
35460801,48,55,1,28,1,0,133,58.64661654135339,35.29411764705882
35460825,188,61,6,24,0,0,279,78.13620071684588,32.96703296703297
35460849,24,66,1,0,2,0,93,29.032258064516125,4.347826086956519
35460898,4308,1153,45,317,10,6,5839,80.25346805959926,24.68974526453298
35461064,220,118,10,160,0,0,508,76.77165354330708,59.02777777777778
35461076,142,56,8,60,0,1,267,79.02621722846442,55.2
35461143,495,86,9,204,0,0,794,89.16876574307304,71.23745819397993
35461167,4,113,0,0,0,0,117,3.4188034188034178,0
35461283,31,16,1,12,0,0,60,73.33333333333334,44.827586206896555
35461295,164,431,40,309,3,0,947,54.48785638859557,44.955300127713926
35461301,138,275,70,514,0,0,997,72.4172517552658,67.98603026775321
35461313,97,167,12,151,1,2,430,61.16279069767442,49.849849849849846
35461325,209,214,49,517,0,0,989,78.36198179979777,72.564102564102555
35461337,105,57,11,53,0,0,226,74.7787610619469,52.892561983471076
35461398,8,38,0,8,0,0,54,29.629629629629626,17.391304347826086
35461404,0,40,0,0,1,0,41,2.4390243902439046,2.4390243902439046
35461441,33,42,4,21,0,0,100,58.00000000000001,37.31343283582089
35461520,42,20,3,8,0,0,73,72.6027397260274,35.483870967741936
35461532,173,371,21,97,2,0,664,44.12650602409639,24.43991853360489
35461573,90,31,5,26,0,0,152,79.60526315789474,50
35461581,1,95,0,1,1,0,98,3.0612244897959218,2.0618556701030966
35461647,2,41,0,0,0,0,43,4.651162790697672,0
35461660,61,26,3,34,1,0,125,79.2,59.375
35461684,112,20,3,25,0,0,160,87.5,58.33333333333333
35461726,64,64,9,37,1,9,184,65.21739130434783,46.666666666666664
35461751,77,36,2,84,0,0,199,81.90954773869346,70.49180327868852
35461908,289,109,10,179,2,7,596,81.71140939597315,64.49511400651467
35461912,346,80,10,82,1,0,519,84.58574181117534,53.75722543352601
35461921,11,33,0,0,0,0,44,25,0
35462524,6,92,0,3,0,0,101,8.910891089108908,3.157894736842104
35462561,66,39,4,30,0,0,139,71.94244604316546,46.57534246575342
35462640,71,19,0,53,1,0,144,86.80555555555556,73.97260273972603
35462731,7,34,1,6,1,0,49,30.612244897959183,19.047619047619047
35462780,51,17,6,15,0,1,90,81.11111111111111,56.41025641025641
35462809,1,65,0,2,1,0,69,5.797101449275366,4.411764705882348
35462810,40,20,1,9,0,0,70,71.42857142857143,33.333333333333336
35462834,89,43,1,4,3,0,140,69.28571428571428,15.686274509803921
35462858,23,37,1,7,3,0,71,47.887323943661976,22.916666666666664
35462962,155,70,7,80,1,1,314,77.70700636942675,55.9748427672956
35462998,54,22,2,18,0,0,96,77.08333333333334,47.61904761904761
35463061,128,515,46,299,0,1,989,47.92719919110212,40.185830429732874
35463073,306,332,41,301,2,1,983,66.22583926754832,50.960118168389954
35463103,10,16,4,28,0,0,58,72.41379310344827,66.66666666666667
35463139,30,16,0,15,0,0,61,73.77049180327869,48.38709677419355
35463152,46,18,1,20,0,1,86,79.06976744186046,55.00000000000001
35463176,47,0,0,0,0,0,47,100,NaN
35463197,39,25,1,10,0,0,75,66.66666666666667,30.555555555555557
35463218,11,24,2,7,0,0,44,45.45454545454546,27.27272727272727
35463224,26,28,4,8,1,0,67,58.2089552238806,31.707317073170728
35463279,873,599,13,18,22,0,1525,60.721311475409834,8.128834355828218
35463536,107,30,2,26,1,0,166,81.92771084337349,49.152542372881356
35463553,52,14,1,12,0,0,79,82.27848101265822,48.14814814814815
35463565,59,11,0,8,1,0,79,86.07594936708861,44.99999999999999
35463577,68,8,2,2,0,0,80,90,33.333333333333336
35463619,25,21,2,17,0,0,65,67.6923076923077,47.5
35463848,4,43,1,11,0,0,59,27.118644067796616,21.818181818181813
35463954,11,53,1,10,0,0,75,29.333333333333332,17.1875
35464016,123,96,5,40,1,1,266,63.90977443609023,32.86713286713287
35464028,49,22,1,20,0,0,92,76.08695652173914,48.837209302325576
35464089,435,106,14,164,2,0,721,85.29819694868239,62.93706293706294
35464132,5,75,0,0,0,0,80,6.25,0
35464181,15,20,0,23,0,0,58,65.51724137931035,53.48837209302326
35464193,56,14,0,4,0,0,74,81.08108108108108,22.22222222222222
35464211,20,78,2,0,30,0,130,40,29.09090909090909
35464235,18,56,4,21,4,0,103,45.63106796116505,34.11764705882353
35464272,43,66,3,1,0,0,113,41.5929203539823,5.714285714285716
35464417,70,6,0,1,0,0,77,92.20779220779221,14.28571428571429
35464430,9,48,10,26,0,0,93,48.38709677419355,42.85714285714286
35464661,32,14,0,14,0,1,61,77.04918032786885,51.72413793103448
35464673,31,61,3,62,3,0,160,61.875,52.71317829457365
35464818,19,56,3,15,0,0,93,39.784946236559136,24.32432432432432
35464961,160,189,11,62,1,1,424,55.4245283018868,28.409090909090907
35465574,58,85,4,9,1,1,158,46.20253164556962,15.000000000000002
35465719,35,77,7,11,1,2,133,42.10526315789473,21.42857142857143
35466712,65,36,4,10,0,0,115,68.69565217391305,28.000000000000004
35467042,38,86,0,1,1,0,126,31.746031746031743,2.2727272727272707
35467054,46,75,0,2,1,0,124,39.516129032258064,3.8461538461538436
35467108,254,357,51,291,1,0,954,62.57861635220125,49
35467170,68,12,2,3,1,0,86,86.04651162790698,33.333333333333336
35467182,19,59,7,25,2,0,112,47.32142857142857,36.55913978494624
35467406,41,51,4,29,0,0,125,59.20000000000001,39.28571428571429
35467789,78,70,3,12,1,6,170,58.82352941176471,23.913043478260864
35468034,29,27,0,4,0,0,60,55.00000000000001,12.903225806451612
35468290,65,38,2,19,1,0,125,69.6,36.66666666666667
35468344,260,139,14,67,0,1,481,71.1018711018711,37.10407239819005
35468423,93,22,0,7,1,0,123,82.11382113821138,26.66666666666667
35468551,46,14,1,17,2,0,80,82.5,58.82352941176471
35468642,23,27,6,19,4,0,79,65.82278481012658,51.78571428571428
35468770,90,68,4,17,3,0,182,62.637362637362635,26.086956521739136
35468903,1,104,1,2,16,0,124,16.129032258064512,15.44715447154471
35468988,79,35,2,41,0,0,157,77.70700636942675,55.12820512820513
35469026,199,59,7,46,0,1,312,81.08974358974359,47.78761061946902
35469048,11,29,1,7,0,0,48,39.583333333333336,21.62162162162162
35469300,186,368,2,9,25,0,590,37.62711864406779,8.910891089108908
35469312,10,63,0,1,2,0,76,17.105263157894733,4.545454545454541
35469713,205,229,4,49,2,0,489,53.16973415132924,19.36619718309859
35469932,18,69,0,2,0,0,89,22.47191011235955,2.8169014084507005
35470200,29,52,0,8,1,0,90,42.22222222222223,14.754098360655743
35470260,14,49,3,10,0,0,76,35.526315789473685,20.967741935483875
35470430,22,41,2,9,1,0,75,45.333333333333336,22.64150943396226
35470454,38,3,1,0,0,0,42,92.85714285714286,25
35470466,48,8,3,4,0,0,63,87.3015873015873,46.666666666666664
35470485,20,21,2,20,1,1,65,67.6923076923077,53.333333333333336
35470727,4,120,1,1,9,0,135,11.111111111111116,8.3969465648855
35470776,36,14,1,18,0,0,69,79.71014492753623,57.57575757575757
35470818,188,497,28,83,2,1,799,37.79724655819775,18.65793780687398
35470879,43,19,1,15,0,0,78,75.64102564102564,45.714285714285715
35470880,33,18,4,11,0,0,66,72.72727272727273,45.45454545454546
35470909,59,43,2,12,0,0,116,62.93103448275862,24.561403508771928
35470934,11,39,0,1,0,0,51,23.529411764705888,2.500000000000002
35470958,132,38,1,34,0,0,205,81.46341463414635,47.945205479452056
35470971,37,20,0,22,0,0,79,74.68354430379746,52.38095238095239
35471012,39,16,1,11,0,0,67,76.11940298507463,42.85714285714286
35471021,74,42,1,32,0,6,155,72.90322580645162,48.14814814814815
35471033,117,31,5,32,1,0,186,83.33333333333334,55.072463768115945
35471297,41,42,8,39,1,0,131,67.93893129770993,53.333333333333336
35471422,128,145,11,81,0,0,365,60.273972602739725,38.81856540084389
35471781,3,81,1,4,8,0,97,16.49484536082474,13.829787234042556
35471860,53,2,0,0,1,0,56,96.42857142857143,33.333333333333336
35472025,86,55,4,59,1,1,206,73.30097087378641,54.16666666666667
35472177,33,11,0,23,1,0,68,83.82352941176471,68.57142857142857
35472256,51,43,1,8,0,0,103,58.252427184466015,17.307692307692314
35472293,19,23,2,11,0,0,55,58.18181818181818,36.111111111111114
35472335,44,25,0,35,2,0,106,76.41509433962264,59.67741935483871
35472426,23,119,1,4,0,0,147,19.047619047619047,4.0322580645161255
35472475,41,21,1,7,0,0,70,70,27.586206896551722
35472487,53,14,0,12,0,0,79,82.27848101265822,46.15384615384615
35472499,56,29,1,25,1,0,112,74.10714285714286,48.21428571428571
35472505,300,485,58,476,5,2,1326,63.42383107088989,52.72904483430799
35472517,7,73,1,0,0,0,81,9.876543209876543,1.3513513513513487
35472803,53,20,4,30,0,1,108,81.4814814814815,63.63636363636363
35473170,53,27,3,15,0,0,98,72.44897959183673,40
35473200,38,16,0,9,2,0,65,75.38461538461539,40.74074074074075
35473212,53,38,3,16,0,0,110,65.45454545454545,33.333333333333336
35473625,88,29,3,13,0,0,133,78.19548872180451,35.55555555555555
35473686,27,38,0,13,0,0,78,51.28205128205128,25.49019607843137
35473819,122,58,4,19,1,1,205,71.70731707317073,30.12048192771084
35474241,69,20,6,17,0,0,112,82.14285714285714,53.48837209302326
35474319,32,41,0,1,1,0,75,45.333333333333336,4.651162790697672
35474548,214,184,14,76,7,4,499,63.12625250501003,35.43859649122807
35474587,51,31,5,51,0,0,138,77.53623188405797,64.36781609195403
35474708,68,33,5,13,1,0,120,72.5,36.53846153846154
35474721,3,83,0,12,0,0,98,15.306122448979586,12.631578947368416
35474733,109,49,4,21,4,0,187,73.79679144385027,37.17948717948718
35474794,37,39,4,0,2,0,82,52.4390243902439,13.33333333333333
35474800,7,163,0,4,4,0,178,8.42696629213483,4.678362573099415
35474812,123,80,10,63,0,0,276,71.01449275362319,47.71241830065359
35475245,96,42,3,36,0,0,177,76.27118644067797,48.14814814814815
35475634,178,80,3,20,3,0,284,71.83098591549295,24.52830188679245
35475786,0,57,0,0,0,0,57,0,0
35475981,114,31,5,19,0,1,170,81.76470588235294,44.64285714285714
35476195,76,46,1,76,4,1,204,77.45098039215686,64.0625
35476249,62,14,3,14,0,0,93,84.94623655913979,54.83870967741935
35476365,220,252,15,89,11,1,588,57.14285714285714,31.521739130434778
35476377,72,32,6,27,0,0,137,76.64233576642336,50.76923076923077
35476473,41,60,4,23,0,0,128,53.125,31.034482758620683
35476481,41,17,1,11,0,0,70,75.71428571428571,41.379310344827594
35476821,43,9,3,12,1,0,68,86.76470588235294,64
35476833,52,60,0,9,0,0,121,50.413223140495866,13.043478260869568
35476845,56,27,0,21,0,0,104,74.03846153846155,43.75
35477175,129,203,5,21,6,0,364,44.230769230769226,13.617021276595743
35477217,69,30,0,11,0,0,110,72.72727272727273,26.82926829268293
35477278,104,52,9,60,0,0,225,76.8888888888889,57.02479338842975
35477461,27,43,15,65,2,0,152,71.71052631578947,65.60000000000001
35477606,74,17,1,13,0,0,105,83.80952380952381,45.16129032258065
35477771,46,41,10,51,0,0,148,72.2972972972973,59.80392156862745
35477886,49,208,3,14,2,1,277,24.90974729241877,8.771929824561408
35477898,13,113,10,68,0,0,204,44.607843137254896,40.83769633507853
35477916,72,225,12,120,0,0,429,47.55244755244755,36.97478991596639
35477928,50,78,11,36,0,1,176,55.68181818181819,38.095238095238095
35477936,256,487,30,231,5,4,1013,51.924975320829226,35.66710700132101
35477965,117,31,1,18,0,0,167,81.437125748502993,38
35477977,389,153,11,238,1,0,792,80.68181818181819,62.0347394540943
35478040,33,23,5,17,2,0,80,71.25,51.06382978723405
35478180,35,22,2,3,0,0,62,64.51612903225806,18.518518518518523
35478246,81,24,3,28,1,0,137,82.48175182481752,57.14285714285714
35478271,1,44,1,0,7,0,53,16.981132075471695,15.384615384615385
35478283,83,27,2,34,0,0,146,81.5068493150685,57.14285714285714
35478386,48,37,5,24,0,0,114,67.54385964912281,43.939393939393945
35478398,128,21,2,41,0,0,192,89.0625,67.1875
35478404,116,54,18,35,0,0,223,75.7847533632287,49.532710280373834
35478416,174,154,20,156,2,0,506,69.56521739130434,53.6144578313253
35478507,137,33,2,29,0,0,201,83.5820895522388,48.4375
35478520,80,42,6,36,0,1,165,74.54545454545455,50.588235294117645
35478532,68,44,2,76,0,0,190,76.84210526315789,63.934426229508205
35478581,57,35,3,33,0,0,128,72.65625,50.70422535211267
35478600,82,26,3,47,0,1,159,83.64779874213836,66.23376623376623
35478672,100,86,12,28,1,1,228,62.28070175438596,32.8125
35478684,60,19,2,31,0,0,112,83.03571428571428,63.46153846153846
35478702,56,25,2,6,3,0,92,72.82608695652173,30.555555555555557
35478842,56,42,10,47,0,0,155,72.90322580645162,57.57575757575757
35478878,40,10,1,7,0,0,58,82.75862068965517,44.44444444444444
35478885,23,22,5,28,0,0,78,71.7948717948718,60
35478945,53,58,3,29,1,0,144,59.72222222222222,36.26373626373627
35478957,65,22,4,27,0,0,118,81.35593220338984,58.490566037735846
35478970,72,33,1,20,0,0,126,73.80952380952381,38.888888888888886
35479019,36,45,2,4,1,0,88,48.86363636363637,13.461538461538458
35479081,267,473,53,516,1,3,1313,63.975628332063984,54.780114722753346
35479135,22,21,7,51,0,1,102,79.41176470588236,73.75
35479251,44,9,2,6,1,0,62,85.48387096774194,50
35479275,39,47,0,11,0,0,97,51.546391752577314,18.965517241379317
35479287,33,24,3,9,0,0,69,65.21739130434783,33.333333333333336
35479482,365,47,9,72,1,0,494,90.48582995951418,63.565891472868216
35479500,210,214,22,167,0,1,614,65.14657980456026,47.02970297029702
35479512,39,22,4,27,1,0,93,76.34408602150538,59.25925925925925
35479524,26,21,1,23,0,1,72,70.83333333333333,54.347826086956516
35479559,73,39,3,64,0,1,180,78.33333333333333,63.55140186915889
35479561,199,34,2,29,1,0,265,87.16981132075472,48.484848484848484
35479597,84,21,2,14,0,0,121,82.64462809917356,43.24324324324324
35479603,76,15,0,29,0,0,120,87.5,65.90909090909092
35479615,12,76,9,16,2,1,116,34.48275862068966,26.923076923076927
35479640,66,32,4,25,1,1,129,75.1937984496124,49.20634920634921
35479652,215,57,6,47,0,0,325,82.46153846153847,48.18181818181818
35479688,293,116,13,174,0,0,596,80.53691275167785,61.71617161716172
35480289,39,115,1,6,1,0,162,29.01234567901234,6.504065040650408
35480307,57,12,3,8,0,0,80,85,47.82608695652174
35480459,201,67,8,64,1,0,341,80.35190615835776,52.14285714285714
35480563,68,64,2,13,0,1,148,56.75675675675676,19.999999999999996
35480575,120,20,1,65,0,0,206,90.29126213592234,76.74418604651163
35480605,58,31,2,10,0,0,101,69.3069306930693,27.906976744186053
35480666,36,34,4,21,0,1,96,64.58333333333333,43.333333333333336
35480733,23,189,7,6,1,0,226,16.371681415929206,6.896551724137934
35480745,692,190,2,1,1,2,888,78.6036036036036,3.0612244897959218
35480848,67,22,1,50,0,0,140,84.28571428571429,69.86301369863014
35480873,57,12,2,8,0,0,79,84.81012658227847,45.45454545454546
35480885,52,110,1,16,0,0,179,38.547486033519554,13.38582677165354
35480939,58,22,0,1,0,0,81,72.8395061728395,4.347826086956519
35480964,48,15,1,16,0,0,80,81.25,53.125
35481129,106,28,1,25,0,0,160,82.5,48.14814814814815
35481154,151,152,4,14,3,0,324,53.086419753086425,12.138728323699421
35481178,22,49,0,9,1,0,81,39.50617283950617,16.94915254237288
35481294,80,28,4,5,1,0,118,76.27118644067797,26.315789473684216
35481300,4,60,0,1,6,0,71,15.492957746478876,10.447761194029848
35481452,242,297,27,285,0,1,852,65.14084507042254,51.31147540983607
35481464,72,22,3,16,0,0,113,80.53097345132744,46.34146341463414
35481610,24,60,3,3,0,0,90,33.333333333333336,9.090909090909093
35481786,98,40,0,36,0,0,174,77.01149425287358,47.36842105263158
35481804,228,39,4,16,0,0,287,86.41114982578398,33.89830508474576
35481816,118,48,7,58,0,0,231,79.2207792207792,57.52212389380531
35481828,2,83,1,1,0,0,87,4.597701149425292,2.352941176470591
35481889,52,14,4,10,0,0,80,82.5,50
35481932,205,163,15,135,1,0,519,68.59344894026975,48.089171974522294
35481944,104,13,4,49,0,1,171,92.39766081871346,80.59701492537313
35482018,8,37,0,28,0,0,73,49.31506849315068,43.07692307692308
35482024,75,32,0,19,0,0,126,74.60317460317461,37.254901960784316
35482043,5,153,4,106,2,0,270,43.333333333333336,42.26415094339623
35482055,332,169,21,156,4,1,683,75.25622254758419,51.85185185185186
35482079,100,173,7,21,2,0,303,42.9042904290429,14.778325123152714
35482134,29,23,5,8,2,0,67,65.67164179104478,39.473684210526315
35482237,63,40,1,24,1,0,129,68.9922480620155,39.39393939393939
35482250,17,19,1,25,1,0,63,69.84126984126983,58.69565217391304
35482262,40,27,2,83,1,0,153,82.35294117647058,76.10619469026548
35482298,82,22,2,25,0,0,131,83.20610687022901,55.10204081632652
35482336,197,46,5,70,0,0,318,85.53459119496856,61.98347107438016
35482341,208,360,33,248,8,0,857,57.99299883313886,44.53004622496148
35482365,26,16,3,19,1,0,65,75.38461538461539,58.97435897435898
35482389,28,24,3,22,2,0,79,69.62025316455696,52.94117647058824
35482547,41,10,1,8,0,0,60,83.33333333333334,47.36842105263158
35482560,107,10,1,14,0,0,132,92.42424242424242,60
35482626,85,53,2,13,1,0,154,65.5844155844156,23.188405797101453
35482651,20,23,5,15,0,0,63,63.49206349206349,46.51162790697675
35482663,27,23,1,9,0,0,60,61.66666666666667,30.303030303030297
35482675,43,11,0,6,0,0,60,81.66666666666667,35.29411764705882
35482687,45,95,6,96,0,0,242,60.74380165289256,51.776649746192895
35482699,132,60,5,75,0,0,272,77.94117647058823,57.14285714285714
35482717,94,28,0,16,1,0,139,79.85611510791367,37.77777777777778
35482742,90,28,2,16,0,0,136,79.41176470588236,39.13043478260869
35482785,52,13,2,11,0,0,78,83.33333333333334,50
35482791,39,34,6,19,0,0,98,65.3061224489796,42.3728813559322
35482821,39,27,2,17,0,0,85,68.23529411764706,41.30434782608695
35482833,13,50,3,2,0,0,68,26.470588235294112,9.090909090909093
35482912,24,66,7,36,0,0,133,50.37593984962406,39.449541284403665
35483023,187,98,13,52,2,0,352,72.15909090909092,40.6060606060606
35483059,187,61,0,40,0,0,288,78.81944444444444,39.603960396039604
35483060,12,70,6,99,0,0,187,62.5668449197861,60
35483096,224,67,9,141,3,0,444,84.90990990990991,69.54545454545455
35483126,8,152,0,1,14,0,175,13.142857142857146,8.982035928143716
35483138,2,43,1,5,4,0,55,21.818181818181813,18.867924528301884
35483345,10,36,3,5,0,0,54,33.333333333333336,18.181818181818176
35483369,178,139,12,66,1,0,396,64.8989898989899,36.23853211009175
35483436,103,28,0,27,0,0,158,82.27848101265822,49.09090909090909
35483631,296,195,31,191,2,2,717,72.80334728033473,53.681710213776725
35483643,420,310,27,183,0,0,940,67.02127659574468,40.38461538461539
35483655,51,20,1,34,0,0,106,81.13207547169812,63.63636363636363
35483722,40,2,0,0,0,0,42,95.23809523809523,0
35483734,64,85,20,40,0,0,209,59.33014354066985,41.379310344827594
35486802,82,230,29,91,3,0,435,47.12643678160919,34.84419263456091
35488215,72,25,7,18,0,0,122,79.50819672131148,50
35489335,67,17,2,14,0,0,100,83,48.484848484848484
35495177,65,28,1,11,0,0,105,73.33333333333334,30.000000000000004
35495335,160,25,6,75,0,0,266,90.6015037593985,76.41509433962264
35495426,45,44,18,44,1,0,152,71.05263157894737,58.87850467289719
35495451,58,27,7,74,0,0,166,83.73493975903614,75
35495608,11,102,2,5,3,0,123,17.07317073170732,8.92857142857143
35495612,50,36,1,27,0,0,114,68.42105263157895,43.75
35495694,1,32,0,10,0,0,43,25.581395348837212,23.809523809523814
35495700,18,10,1,58,1,0,88,88.63636363636364,85.71428571428572
35495748,54,194,33,225,3,1,510,61.96078431372549,57.45614035087719
35495773,88,263,4,5,109,1,470,44.04255319148936,31.151832460732987
35495785,98,19,1,11,0,0,129,85.27131782945736,38.70967741935484
35495803,54,26,3,9,0,0,92,71.73913043478262,31.57894736842105
35495943,11,36,2,16,0,0,65,44.61538461538461,33.333333333333336
35496169,177,27,3,31,0,0,238,88.65546218487394,55.73770491803278
35496424,33,24,2,16,1,0,76,68.42105263157895,44.18604651162791
35496561,32,60,8,17,0,0,117,48.71794871794872,29.411764705882348
35496625,123,75,6,23,0,0,227,66.96035242290749,27.884615384615387
35496789,109,22,3,43,1,0,178,87.64044943820225,68.11594202898551
35496820,1,71,0,0,0,0,72,1.388888888888884,0
35496868,43,46,4,32,1,2,128,64.0625,45.88235294117647
35496873,13,47,11,34,0,0,105,55.23809523809524,48.91304347826087
35497009,33,140,1,6,1,0,181,22.651933701657455,5.405405405405405
35497162,50,50,6,23,1,1,131,61.832061068702295,38.27160493827161
35497174,33,18,2,14,0,0,67,73.13432835820896,47.05882352941176
35497198,97,69,7,27,0,0,200,65.5,33.009708737864074
35497204,140,43,5,39,2,0,229,81.22270742358079,51.685393258426956
35497216,67,32,4,27,0,0,130,75.38461538461539,49.20634920634921
35497228,28,77,5,46,4,0,160,51.87500000000001,41.666666666666664
35497344,4,48,0,4,3,0,59,18.644067796610166,12.727272727272732
35497393,78,28,5,26,0,0,137,79.56204379562044,52.542372881355924
35497654,12,37,1,3,0,0,53,30.188679245283023,9.756097560975608
35497757,24,36,17,33,1,1,112,67.85714285714286,59.09090909090908
35498002,10,67,1,1,0,0,79,15.189873417721522,2.898550724637683
35498014,24,11,4,20,0,0,59,81.35593220338984,68.57142857142857
35498117,21,24,6,19,0,0,70,65.71428571428571,51.02040816326531
35498185,66,14,3,17,0,0,100,86,58.82352941176471
35498385,33,24,2,3,0,0,62,61.29032258064516,17.24137931034483
35498440,5,58,0,2,0,0,65,10.769230769230765,3.3333333333333326
35498531,60,23,1,12,0,0,96,76.04166666666666,36.111111111111114
35498543,105,45,5,55,0,0,210,78.57142857142857,57.14285714285714
35498622,94,38,1,18,0,0,151,74.83443708609272,33.333333333333336
35498634,88,193,13,67,3,2,366,47.267759562841526,30.575539568345324
35498646,114,151,10,57,2,0,334,54.79041916167664,31.36363636363636
35498695,3,63,0,3,6,0,75,16.000000000000004,12.5
35498774,10,51,0,2,13,0,76,32.89473684210527,22.72727272727273
35498877,65,194,3,17,1,0,280,30.714285714285715,9.76744186046512
35499407,84,4,0,25,1,0,114,96.49122807017544,86.66666666666667
35499481,59,21,3,7,0,0,90,76.66666666666666,32.25806451612904
35499493,99,42,1,39,0,0,181,76.79558011049724,48.78048780487805
35499547,90,54,4,21,3,0,172,68.6046511627907,34.14634146341463
35499572,69,33,2,16,1,0,121,72.72727272727273,36.53846153846154
35499882,108,56,8,38,0,1,211,73.45971563981041,45.63106796116505
35501924,105,82,7,23,1,1,219,62.55707762557078,28.07017543859649
35503897,14,52,10,13,0,0,89,41.57303370786517,30.666666666666664
35507131,98,35,3,43,0,0,179,80.44692737430168,56.790123456790134
35507261,34,16,1,43,0,0,94,82.97872340425532,73.33333333333334
35507830,28,156,0,19,2,0,205,23.902439024390244,11.864406779661019
35507866,10,57,2,12,1,1,83,31.32530120481928,21.91780821917808
35513210,808,293,28,352,5,7,1493,80.37508372404555,57.22627737226278
35514202,6,43,2,9,0,0,60,28.333333333333332,20.370370370370374
35516223,21,58,5,19,1,0,104,44.230769230769226,30.12048192771084
35518578,54,176,6,17,0,0,253,30.434782608695656,11.557788944723612
35518694,12,143,1,2,2,0,160,10.624999999999996,3.378378378378377
35518897,162,17,1,60,0,0,240,92.91666666666667,78.2051282051282
35518906,57,41,5,32,0,0,135,69.62962962962963,47.43589743589743
35522247,46,114,1,9,1,0,171,33.333333333333336,8.799999999999997
35522961,20,37,0,3,1,0,61,39.34426229508197,9.756097560975608
35528341,83,41,3,33,0,0,160,74.375,46.753246753246756
35529011,538,285,39,244,1,1,1108,74.27797833935018,50
35529497,210,52,6,23,0,0,291,82.13058419243985,35.802469135802475
35530785,15,35,2,33,0,1,86,59.302325581395344,50.70422535211267
35559210,12,3,1,2,0,179,197,98.47715736040608,98.37837837837837
35559337,16,22,6,25,0,0,69,68.11594202898551,58.490566037735846
35559386,24,36,6,16,0,0,82,56.09756097560976,37.93103448275862
35559600,13,17,4,16,0,1,51,66.66666666666667,55.263157894736835
35559702,18,42,1,35,0,0,96,56.25,46.15384615384615
35559751,5,15,3,19,0,0,42,64.28571428571428,59.45945945945945
35559763,25,24,11,26,0,0,86,72.09302325581395,60.65573770491803
35559775,19,18,6,16,0,0,59,69.4915254237288,55.00000000000001
35559787,10,14,3,15,0,0,42,66.66666666666667,56.25
35560112,9,40,2,10,0,1,62,35.483870967741936,24.52830188679245
35560170,161,118,9,134,0,0,422,72.03791469194313,54.78927203065134
35560182,80,56,9,36,1,0,182,69.23076923076923,45.09803921568627
35560194,33,26,4,17,0,0,80,67.5,44.680851063829785
35560248,32,61,5,18,0,0,116,47.41379310344828,27.380952380952383
35560261,95,190,14,114,0,0,413,53.99515738498789,40.25157232704403
35560339,66,8,1,4,0,0,79,89.87341772151899,38.46153846153846
35560340,112,45,6,18,0,0,181,75.13812154696133,34.78260869565217
35560388,4,39,4,11,0,0,58,32.758620689655174,27.77777777777778
35560397,2,42,2,0,1,0,47,10.63829787234043,6.666666666666665
35560431,322,224,20,227,0,0,793,71.75283732660782,52.4416135881104
35560443,300,516,50,426,0,0,1292,60.06191950464397,47.983870967741936
35560455,36,535,31,635,0,15,1252,57.26837060702875,56.003289473684205
35560467,176,60,2,47,1,0,286,79.02097902097903,45.45454545454546
35560480,102,60,4,30,8,0,204,70.58823529411764,41.17647058823529
35560571,221,87,11,82,0,0,401,78.30423940149626,51.66666666666666
35560820,13,156,2,5,0,0,176,11.363636363636365,4.294478527607359
35560881,2,29,2,34,0,0,67,56.71641791044777,55.38461538461539
35560893,134,32,3,51,0,0,220,85.45454545454545,62.7906976744186
35561101,18,62,4,5,0,1,90,31.11111111111111,13.888888888888884
35561125,148,75,0,9,1,0,233,67.81115879828326,11.764705882352944
35561137,5,30,1,7,0,0,43,30.23255813953488,21.052631578947366
35561174,3,58,0,7,0,0,68,14.70588235294118,10.769230769230765
35561186,99,42,2,63,0,0,206,79.6116504854369,60.747663551401864
35561198,284,80,14,105,2,0,485,83.50515463917526,60.19900497512438
35561368,131,19,9,57,1,0,217,91.24423963133641,77.90697674418605
35561373,123,79,16,134,0,0,352,77.55681818181819,65.50218340611353
35561393,93,46,2,38,1,0,180,74.44444444444444,47.12643678160919
35561459,52,10,0,16,2,0,80,87.5,64.28571428571428
35561514,0,46,0,0,2,0,48,4.1666666666666625,4.1666666666666625
35561526,50,40,0,55,1,0,146,72.6027397260274,58.33333333333333
35561548,25,33,1,20,1,0,80,58.75,40
35561551,159,38,0,0,1,0,198,80.8080808080808,2.564102564102566
35561685,89,9,0,0,0,0,98,90.81632653061224,0
35562014,78,28,4,30,0,1,141,80.1418439716312,55.55555555555556
35562026,16,35,2,24,0,0,77,54.54545454545454,42.622950819672134
35562099,1,44,0,5,1,0,51,13.725490196078427,12
35562105,0,14,2,27,0,0,43,67.44186046511628,67.44186046511628
35562129,3,54,0,23,2,0,82,34.14634146341463,31.645569620253166
35562233,27,12,0,0,2,0,41,70.73170731707317,14.28571428571429
35562361,31,33,0,14,0,0,78,57.692307692307686,29.78723404255319
35562373,35,46,7,40,0,0,128,64.0625,50.53763440860215
35562828,56,102,4,61,1,0,224,54.46428571428572,39.28571428571429
35562889,11,38,4,41,0,0,94,59.57446808510638,54.216867469879524
35562907,100,58,7,65,1,0,231,74.8917748917749,55.72519083969465
35563006,26,52,0,1,11,0,90,42.22222222222223,18.75
35563067,80,42,2,47,0,0,171,75.43859649122807,53.84615384615385
35563079,178,171,38,119,0,0,506,66.20553359683794,47.86585365853659
35563080,53,6,1,19,0,0,79,92.40506329113924,76.92307692307692
35563109,44,34,0,23,2,1,104,67.3076923076923,43.333333333333336
35563110,54,37,3,30,2,1,127,70.86614173228347,49.31506849315068
35563122,295,42,3,36,0,0,376,88.82978723404256,48.14814814814815
35563161,128,81,8,92,2,0,311,73.95498392282957,55.73770491803278
35563171,126,228,30,209,3,0,596,61.74496644295302,51.48936170212765
35563225,119,65,4,35,2,0,225,71.11111111111111,38.67924528301887
35563262,51,15,4,10,0,0,80,81.25,48.275862068965516
35563298,114,112,0,4,2,0,232,51.72413793103448,5.0847457627118615
35563535,34,42,3,7,2,0,88,52.27272727272727,22.22222222222222
35563559,45,16,0,9,0,0,70,77.14285714285715,36
35563626,11,48,1,9,0,0,69,30.434782608695656,17.24137931034483
35563648,131,29,4,27,0,0,191,84.81675392670157,51.66666666666666
35563651,47,10,0,10,0,0,67,85.07462686567165,50
35563742,63,16,5,15,0,0,99,83.83838383838383,55.55555555555556
35563754,75,38,2,20,1,0,136,72.05882352941177,37.704918032786885
35563766,134,54,8,37,2,0,235,77.02127659574468,46.53465346534653
35563778,31,20,4,14,0,0,69,71.01449275362319,47.36842105263158
35563785,7,27,4,324,1,0,363,92.56198347107438,92.41573033707866
35563812,12,61,4,1,0,0,78,21.794871794871796,7.57575757575758
35563833,55,15,1,21,0,0,92,83.69565217391303,59.45945945945945
35563845,112,7,0,12,0,0,131,94.65648854961832,63.1578947368421
35563973,11,42,0,0,0,0,53,20.75471698113207,0
35564072,19,113,1,2,0,0,135,16.296296296296298,2.5862068965517238
35564151,63,45,5,19,0,0,132,65.90909090909092,34.78260869565217
35564345,44,10,3,28,0,0,85,88.23529411764706,75.60975609756098
35564527,0,43,2,0,0,0,45,4.444444444444439,4.444444444444439
35564539,16,30,2,18,0,0,66,54.54545454545454,40
35564667,61,40,2,13,0,0,116,65.51724137931035,27.27272727272727
35564850,37,16,2,21,1,0,77,79.2207792207792,60
35564862,75,33,1,31,0,0,140,76.42857142857142,49.23076923076923
35564904,47,36,7,33,1,0,124,70.96774193548387,53.24675324675325
35564936,44,14,2,20,0,0,80,82.5,61.111111111111114
35564941,61,22,1,30,0,0,114,80.70175438596492,58.490566037735846
35565015,92,27,0,16,0,0,135,80,37.2093023255814
35565124,46,22,0,7,3,0,78,71.7948717948718,31.25
35565143,43,28,2,17,2,0,92,69.56521739130434,42.85714285714286
35565155,5,54,9,28,0,1,97,44.329896907216494,41.30434782608695
35565179,60,8,4,21,0,0,93,91.39784946236558,75.75757575757575
35565210,80,29,2,25,1,0,137,78.83211678832117,49.122807017543856
35565234,27,38,2,9,0,0,76,50,22.44897959183674
35565313,112,45,4,59,0,0,220,79.54545454545455,58.33333333333333
35565349,38,9,1,10,0,0,58,84.48275862068965,55.00000000000001
35565386,89,22,1,20,1,0,133,83.45864661654136,50
35565398,77,31,4,26,0,0,138,77.53623188405797,49.18032786885246
35565507,47,20,0,8,0,0,75,73.33333333333334,28.57142857142857
35565544,35,29,3,21,0,0,88,67.04545454545455,45.28301886792453
35565581,152,34,1,22,1,0,210,83.80952380952381,41.379310344827594
35565600,58,14,1,6,0,0,79,82.27848101265822,33.333333333333336
35565611,178,48,9,27,0,0,262,81.67938931297711,42.85714285714286
35565623,16,49,0,14,0,1,80,38.74999999999999,23.4375
35565635,35,41,1,27,2,0,106,61.32075471698113,42.25352112676056
35565647,24,172,0,1,5,0,202,14.851485148514854,3.3707865168539297
35565659,41,14,4,22,0,0,81,82.71604938271605,65
35565684,20,18,0,5,0,2,45,60,28.000000000000004
35565714,47,44,9,54,0,0,154,71.42857142857143,58.87850467289719
35565738,27,38,1,10,0,0,76,50,22.44897959183674
35565751,66,341,5,3,4,0,419,18.61575178997613,3.399433427762044
35565787,103,34,1,26,0,0,164,79.26829268292683,44.26229508196722
35565799,172,28,1,26,0,0,227,87.66519823788546,49.09090909090909
35565969,80,11,1,17,0,0,109,89.90825688073394,62.06896551724138
35565970,71,27,3,15,0,0,116,76.72413793103449,40
35566020,493,272,28,231,4,1,1029,73.56656948493682,49.25373134328358
35566123,48,56,1,19,1,0,125,55.2,27.27272727272727
35566147,92,5,1,8,1,0,107,95.32710280373831,66.66666666666667
35566159,117,42,3,55,1,0,218,80.73394495412845,58.41584158415842
35566184,60,21,0,7,0,0,88,76.13636363636364,25
35566226,100,31,6,22,0,0,159,80.50314465408806,47.45762711864406
35566238,89,26,2,18,1,0,136,80.88235294117648,44.680851063829785
35566251,59,17,2,10,1,0,89,80.89887640449437,43.333333333333336
35566342,46,13,2,8,1,0,70,81.42857142857143,45.833333333333336
35566385,39,9,0,21,0,1,70,87.14285714285714,70.96774193548387
35566412,49,25,3,23,0,0,100,75,50.98039215686274
35566457,82,34,3,14,1,0,134,74.62686567164178,34.61538461538461
35566494,53,21,3,17,0,0,94,77.65957446808511,48.78048780487805
35566512,78,66,1,20,1,0,166,60.24096385542168,25
35566548,27,13,2,28,0,0,70,81.42857142857143,69.76744186046511
35566603,70,32,3,21,0,0,126,74.60317460317461,42.85714285714286
35566615,273,60,9,33,1,0,376,84.04255319148936,41.747572815533985
35566639,87,71,6,31,0,0,195,63.589743589743584,34.25925925925925
35566640,78,34,2,21,2,0,137,75.18248175182481,42.3728813559322
35566664,80,54,4,19,0,0,157,65.60509554140128,29.87012987012987
35566676,34,31,5,10,0,0,80,61.25000000000001,32.608695652173914
35566718,208,98,18,108,0,0,432,77.31481481481481,56.25
35566834,82,143,15,135,1,0,376,61.968085106382986,51.36054421768708
35566871,42,5,0,7,0,0,54,90.74074074074075,58.33333333333333
35567048,326,404,24,282,0,4,1040,61.15384615384616,43.417366946778714
35567085,89,30,9,25,0,0,153,80.3921568627451,53.125
35567097,48,17,0,11,2,0,78,78.2051282051282,43.333333333333336
35567103,116,35,2,14,1,0,168,79.16666666666666,32.692307692307686
35567115,95,54,2,18,3,0,172,68.6046511627907,29.87012987012987
35567127,97,29,4,23,0,0,153,81.04575163398692,48.21428571428571
35567139,50,7,0,12,0,0,69,89.85507246376811,63.1578947368421
35567504,1,41,1,7,0,0,50,18.000000000000004,16.326530612244895
35567516,135,330,5,14,0,0,484,31.818181818181824,5.444126074498568
35567553,52,38,7,17,0,0,114,66.66666666666667,38.70967741935484
35567565,25,34,2,37,0,0,98,65.3061224489796,53.42465753424658
35567693,52,19,2,7,0,0,80,76.25,32.14285714285714
35567711,36,41,4,11,0,1,93,55.91397849462365,28.07017543859649
35567747,50,32,2,46,0,0,130,75.38461538461539,60
35567802,68,31,1,32,0,0,132,76.51515151515152,51.5625
35567814,3,70,1,8,0,0,82,14.634146341463417,11.392405063291145
35567826,116,30,3,50,0,0,199,84.92462311557789,63.85542168674698
35567917,56,24,1,16,0,0,97,75.25773195876289,41.463414634146346
35567978,66,53,3,56,0,0,178,70.2247191011236,52.67857142857143
35567985,110,126,3,26,1,0,266,52.63157894736843,19.23076923076923
35567991,17,18,2,29,0,0,66,72.72727272727273,63.26530612244898
35568016,35,75,5,32,0,0,147,48.97959183673469,33.03571428571429
35568041,73,16,1,31,0,1,122,86.88524590163934,67.34693877551021
35568053,29,43,5,16,0,0,93,53.76344086021505,32.8125
35568065,9,21,2,31,0,0,63,66.66666666666667,61.111111111111114
35568077,18,22,2,23,0,0,65,66.15384615384615,53.191489361702125
35568090,13,67,0,1,0,0,81,17.28395061728395,1.4705882352941124
35568120,24,278,37,319,0,0,658,57.75075987841946,56.15141955835963
35568193,36,194,1,4,1,1,237,18.143459915611814,3.482587064676612
35568200,26,243,2,3,19,0,293,17.064846416382252,8.98876404494382
35568399,20,25,1,21,2,0,69,63.76811594202898,48.97959183673469
35568429,32,29,3,26,0,0,90,67.77777777777779,50
35568466,47,69,2,14,0,0,132,47.72727272727273,18.823529411764707
35568478,72,21,1,10,2,0,106,80.18867924528301,38.23529411764706
35568485,46,21,1,14,0,0,82,74.39024390243902,41.666666666666664
35568512,26,41,1,0,0,0,68,39.70588235294118,2.3809523809523836
35568533,91,94,4,10,1,0,200,53,13.761467889908252
35568557,31,10,1,4,0,0,46,78.26086956521739,33.333333333333336
35568570,69,32,0,13,0,0,114,71.9298245614035,28.888888888888886
35568600,72,24,4,31,1,1,133,81.95488721804512,60.65573770491803
35568685,27,27,3,11,0,0,68,60.29411764705883,34.14634146341463
35568715,0,76,22,110,0,2,210,63.8095238095238,63.8095238095238
35568892,80,114,2,21,0,0,217,47.46543778801844,16.788321167883215
35568971,149,25,0,11,0,0,185,86.48648648648648,30.555555555555557
35569021,192,238,26,269,6,1,732,67.4863387978142,55.925925925925924
35569033,146,45,3,43,0,0,237,81.0126582278481,50.54945054945055
35569057,20,68,1,17,0,0,106,35.84905660377359,20.93023255813954
35569069,50,43,1,43,2,0,139,69.06474820143885,51.685393258426956
35569094,54,35,7,22,1,0,119,70.58823529411764,46.15384615384615
35569203,0,57,0,1,0,0,58,1.7241379310344862,1.7241379310344862
35569215,86,6,0,0,0,0,92,93.47826086956522,0
35569239,36,23,0,1,0,0,60,61.66666666666667,4.1666666666666625
35569240,168,148,8,12,0,0,336,55.952380952380956,11.904761904761907
35569434,39,12,0,15,0,0,66,81.81818181818181,55.55555555555556
35569446,40,30,4,31,0,0,105,71.42857142857143,53.84615384615385
35569458,3,40,4,18,0,0,65,38.46153846153846,35.483870967741936
35569461,22,21,3,19,0,0,65,67.6923076923077,51.162790697674424
35569641,9,89,0,37,4,0,139,35.97122302158273,31.538461538461537
35569781,80,9,3,40,0,0,132,93.18181818181819,82.6923076923077
35569800,184,31,1,123,1,0,340,90.88235294117646,80.12820512820514
35569811,69,23,1,13,2,0,108,78.7037037037037,41.02564102564102
35569859,47,16,1,20,0,0,84,80.95238095238095,56.75675675675676
35569860,92,21,2,37,0,0,152,86.18421052631578,65
35569884,182,58,10,65,0,1,316,81.64556962025317,56.71641791044777
35569987,64,37,5,32,1,0,139,73.38129496402878,50.66666666666666
35570102,45,34,2,10,1,0,92,63.04347826086957,27.6595744680851
35570515,26,48,8,51,1,0,134,64.17910447761194,55.55555555555556
35571155,8,207,0,0,0,0,215,3.7209302325581395,0
35571416,209,39,3,87,0,1,339,88.49557522123894,70
35572408,69,32,3,24,1,0,129,75.1937984496124,46.666666666666664
35572469,174,34,4,32,1,0,245,86.12244897959184,52.112676056338024
35573905,198,51,1,22,0,0,272,81.25,31.081081081081084
35573917,46,18,0,8,0,0,72,75,30.76923076923077
35574211,12,217,42,439,0,1,711,69.47960618846695,68.95565092989986
35574399,2,60,0,1,1,0,64,6.25,3.2258064516129004
35574934,261,92,13,96,0,0,462,80.08658008658008,54.22885572139303
35576104,54,20,1,32,1,0,108,81.4814814814815,62.96296296296296
35576136,44,19,1,14,0,0,78,75.64102564102564,44.11764705882353
35576189,34,41,2,27,0,0,104,60.57692307692308,41.42857142857142
35576190,50,33,2,16,0,0,101,67.32673267326732,35.29411764705882
35576207,128,46,7,27,1,0,209,77.99043062200957,43.20987654320988
35576232,98,39,4,41,1,0,183,78.68852459016394,54.117647058823536
35576244,29,20,1,18,0,0,68,70.58823529411764,48.71794871794872
35576293,65,18,1,9,0,0,93,80.64516129032258,35.71428571428571
35576359,29,9,1,26,0,0,65,86.15384615384616,75
35576396,41,33,7,17,0,0,98,66.3265306122449,42.10526315789473
35576414,122,290,14,32,1,0,459,36.81917211328975,13.946587537091993
35576426,8,41,5,32,0,1,87,52.87356321839081,48.10126582278481
35576542,20,32,0,5,0,0,57,43.85964912280702,13.513513513513509
35576591,102,215,45,90,0,0,452,52.43362831858407,38.57142857142857
35576612,53,83,4,18,1,0,159,47.79874213836478,21.698113207547166
35576621,35,37,5,110,3,1,191,80.6282722513089,76.28205128205127
35576657,110,43,4,45,0,1,203,78.81773399014779,53.76344086021505
35576759,62,27,8,16,1,0,114,76.31578947368422,48.07692307692307
35576797,48,57,6,79,1,0,191,70.15706806282722,60.13986013986015
35576888,62,10,0,2,0,0,74,86.48648648648648,16.666666666666664
35576897,44,16,3,33,0,0,96,83.33333333333334,69.23076923076923
35576992,20,22,1,22,2,0,67,67.16417910447761,53.191489361702125
35577005,110,42,3,59,0,0,214,80.37383177570094,59.61538461538461
35577042,38,21,4,12,1,0,76,72.36842105263158,44.73684210526315
35577054,52,25,2,5,0,0,84,70.23809523809523,21.875
35577085,19,28,2,11,0,0,60,53.333333333333336,31.707317073170728
35577091,29,42,3,41,0,1,116,63.793103448275865,51.72413793103448
35577121,40,20,5,24,0,0,89,77.52808988764045,59.183673469387756
35577133,4,44,2,13,0,0,63,30.15873015873016,25.423728813559322
35577170,60,27,2,21,0,0,110,75.45454545454545,46
35577327,71,28,2,25,0,0,126,77.77777777777779,49.09090909090909
35577339,45,18,0,11,0,0,74,75.67567567567568,37.93103448275862
35577340,80,45,5,28,0,0,158,71.51898734177216,42.307692307692314
35577406,60,11,1,19,2,0,93,88.17204301075269,66.66666666666667
35577424,61,38,2,24,1,0,126,69.84126984126983,41.53846153846153
35577431,63,29,3,26,0,0,121,76.03305785123968,50
35577443,32,31,2,36,0,0,101,69.3069306930693,55.072463768115945
35577455,78,36,2,20,1,0,137,73.72262773722628,38.983050847457626
35577479,29,16,3,16,1,0,65,75.38461538461539,55.55555555555556
35577522,36,43,1,29,0,1,110,60.909090909090914,41.891891891891895
35577534,252,107,7,110,0,0,476,77.52100840336135,52.23214285714286
35577546,63,51,2,22,1,1,140,63.57142857142857,33.76623376623377
35577558,42,28,0,31,0,1,102,72.54901960784314,53.333333333333336
35577561,70,20,0,7,0,0,97,79.38144329896907,25.92592592592593
35577571,101,13,2,3,0,0,119,89.07563025210084,27.77777777777778
35577583,82,29,4,18,0,0,133,78.19548872180451,43.13725490196079
35577595,129,56,8,44,0,0,237,76.37130801687763,48.14814814814815
35577601,7,33,2,30,0,0,72,54.16666666666667,49.23076923076923
35577613,39,16,1,5,0,0,61,73.77049180327869,27.27272727272727
35577625,55,28,1,18,1,0,103,72.81553398058253,41.666666666666664
35577637,5,60,2,3,3,0,73,17.808219178082197,11.764705882352944
35577650,93,21,5,13,0,1,133,84.21052631578947,47.5
35577674,170,21,0,15,2,0,208,89.90384615384616,44.73684210526315
35577728,48,15,3,44,0,0,110,86.36363636363636,75.80645161290323
35577736,52,15,0,31,0,0,98,84.6938775510204,67.3913043478261
35577741,16,40,3,34,0,0,93,56.98924731182795,48.05194805194806
35577753,35,25,1,36,0,0,97,74.22680412371135,59.67741935483871
35577765,61,35,1,51,1,0,149,76.51006711409396,60.22727272727273
35577777,64,20,5,24,0,0,113,82.30088495575221,59.183673469387756
35577789,89,36,3,36,0,0,164,78.04878048780488,52
35577790,34,6,2,29,2,0,73,91.78082191780823,84.61538461538461
35577820,41,12,4,6,0,0,63,80.95238095238095,45.45454545454546
35577844,53,33,2,22,2,0,112,70.53571428571428,44.067796610169495
35577881,22,27,8,137,1,0,195,86.15384615384616,84.39306358381504
35577893,47,19,0,33,0,0,99,80.8080808080808,63.46153846153846
35577935,45,37,1,30,0,0,113,67.25663716814158,45.58823529411765
35577972,68,22,0,14,0,0,104,78.84615384615384,38.888888888888886
35577996,30,30,4,53,0,0,117,74.35897435897436,65.51724137931035
35578010,91,23,4,25,0,0,143,83.91608391608392,55.769230769230774
35578058,86,85,1,25,0,0,197,56.85279187817258,23.42342342342343
35578150,128,60,9,36,1,0,234,74.35897435897436,43.39622641509434
35578162,139,27,3,37,0,0,206,86.89320388349515,59.70149253731343
35578204,22,27,3,27,0,0,79,65.82278481012658,52.63157894736843
35578236,39,21,2,8,1,0,71,70.4225352112676,34.375
35578241,40,14,3,15,0,0,72,80.55555555555556,56.25
35578253,42,52,4,29,0,0,127,59.05511811023623,38.8235294117647
35578277,43,26,2,15,1,0,87,70.11494252873563,40.90909090909091
35578289,83,57,9,67,0,0,216,73.61111111111111,57.14285714285714
35578290,42,21,2,14,0,0,79,73.41772151898735,43.24324324324324
35578307,46,25,1,13,14,0,99,74.74747474747474,52.83018867924528
35578319,48,12,0,10,0,0,70,82.85714285714285,45.45454545454546
35578320,50,18,2,2,3,0,75,76,28.000000000000004
35578332,45,168,13,126,5,2,359,53.2033426183844,46.496815286624205
35578344,314,106,13,124,1,1,559,81.03756708407872,56.73469387755101
35578356,43,38,3,38,1,0,123,69.10569105691057,52.5
35578373,43,11,0,14,1,0,69,84.05797101449275,57.692307692307686
35578393,85,46,5,33,1,0,170,72.94117647058825,45.88235294117647
35578400,41,23,4,22,1,0,91,74.72527472527473,54
35578411,31,20,6,18,0,0,75,73.33333333333334,54.54545454545454
35578460,172,27,1,31,2,0,233,88.41201716738198,55.73770491803278
35578472,62,33,2,21,0,0,118,72.03389830508475,41.07142857142857
35578496,74,25,1,14,1,0,115,78.26086956521739,39.02439024390244
35578502,5,17,2,37,0,0,61,72.1311475409836,69.64285714285714
35578514,49,11,3,7,0,0,70,84.28571428571429,47.61904761904761
35578548,22,27,0,14,1,0,64,57.8125,35.71428571428571
35578551,146,12,0,0,1,0,159,92.45283018867924,7.692307692307687
35578605,6,43,6,42,1,0,98,56.122448979591844,53.260869565217384
35578617,3,44,8,52,0,0,107,58.87850467289719,57.692307692307686
35578629,33,25,1,15,0,0,74,66.21621621621621,39.02439024390244
35578654,12,31,4,25,1,0,73,57.53424657534247,49.18032786885246
35578685,120,36,7,55,1,0,219,83.56164383561644,63.63636363636363
35578691,118,158,5,66,2,0,349,54.72779369627507,31.601731601731597
35578708,84,7,0,6,0,0,97,92.78350515463917,46.15384615384615
35578712,24,22,0,12,1,0,59,62.71186440677966,37.142857142857146
35578757,17,21,5,26,0,1,70,70,60.37735849056604
35578770,43,0,0,0,0,0,43,100,NaN
35578782,29,25,1,31,2,0,88,71.59090909090908,57.6271186440678
35578794,6,15,7,41,0,1,70,78.57142857142857,76.5625
35578800,53,26,7,29,3,0,118,77.96610169491525,60
35578812,46,41,1,37,1,1,127,67.71653543307087,49.382716049382715
35578824,111,62,12,20,0,0,205,69.7560975609756,34.04255319148937
35578836,63,29,1,18,0,0,111,73.87387387387388,39.583333333333336
35578848,63,17,2,22,0,0,104,83.65384615384616,58.53658536585367
35578885,90,51,4,35,0,0,180,71.66666666666667,43.333333333333336
35578927,59,22,1,21,1,0,104,78.84615384615384,51.11111111111111
35578940,76,17,0,41,0,0,134,87.31343283582089,70.6896551724138
35578952,45,50,4,52,0,0,151,66.88741721854305,52.83018867924528
35579002,72,32,2,32,0,0,138,76.81159420289855,51.515151515151516
35579026,21,45,9,38,0,0,113,60.17699115044248,51.08695652173913
35579048,80,35,3,30,0,0,148,76.35135135135135,48.529411764705884
35579051,410,202,30,162,4,0,808,75,49.246231155778894
35579129,78,107,1,3,3,0,192,44.270833333333336,6.140350877192979
35579154,102,50,6,22,0,0,180,72.22222222222221,35.89743589743589
35579166,52,38,8,15,2,0,115,66.95652173913044,39.682539682539684
35579191,36,19,2,10,0,0,67,71.64179104477613,38.70967741935484
35579208,26,43,4,38,0,0,111,61.261261261261254,49.411764705882355
35579245,65,10,2,31,0,1,109,90.82568807339449,77.27272727272727
35579282,27,29,7,3,0,0,66,56.060606060606055,25.64102564102564
35579294,61,40,5,48,0,0,154,74.02597402597402,56.98924731182795
35579300,33,15,2,20,0,0,70,78.57142857142857,59.45945945945945
35579312,71,26,4,22,1,0,124,79.03225806451613,50.943396226415096
35579324,109,23,4,20,0,1,157,85.35031847133759,52.08333333333333
35579336,17,27,2,9,0,0,55,50.90909090909091,28.947368421052634
35579361,15,27,1,26,0,0,69,60.86956521739131,50
35579397,71,32,4,42,0,0,149,78.52348993288591,58.97435897435898
35579415,35,21,4,20,0,0,80,73.75,53.333333333333336
35579452,2,84,4,7,10,0,107,21.495327102803742,19.999999999999996
35579476,81,63,8,46,0,2,200,68.5,47.05882352941176
35579518,69,17,4,19,1,0,110,84.54545454545455,58.53658536585367
35579524,47,53,2,15,0,0,117,54.700854700854705,24.28571428571429
35579531,32,24,4,20,0,0,80,70,50
35579543,213,64,11,62,0,0,350,81.71428571428572,53.284671532846716
35579592,60,14,1,20,0,0,95,85.26315789473684,60
35579658,67,25,0,27,0,0,119,78.99159663865547,51.92307692307692
35579661,41,46,2,34,0,0,123,62.601626016260155,43.90243902439024
35579713,308,126,19,97,2,0,552,77.17391304347827,48.36065573770492
35579725,199,181,17,111,2,2,512,64.6484375,42.17252396166135
35579737,134,137,4,89,0,0,364,62.362637362637365,40.43478260869565
35579749,39,31,4,28,0,1,103,69.90291262135922,51.5625
35579798,245,290,18,101,5,4,663,56.25942684766214,30.622009569377994
35579841,49,21,0,31,1,0,102,79.41176470588236,60.37735849056604
35579907,125,63,14,33,1,0,236,73.30508474576271,43.24324324324324
35579920,14,33,6,16,1,0,70,52.85714285714286,41.07142857142857
35579932,76,29,1,31,2,1,140,79.28571428571428,54.6875
35579956,114,4,0,3,0,0,121,96.69421487603306,42.85714285714286
35579968,108,34,8,15,1,0,166,79.51807228915662,41.379310344827594
35579981,59,24,4,46,2,2,137,82.48175182481752,69.23076923076923
35579993,51,22,1,24,0,0,98,77.55102040816327,53.191489361702125
35580004,83,30,3,19,1,1,137,78.1021897810219,44.44444444444444
35580016,132,40,4,32,0,0,208,80.76923076923077,47.36842105263158
35580028,23,58,4,41,0,0,126,53.968253968253975,43.689320388349515
35580036,115,51,10,62,0,0,238,78.57142857142857,58.53658536585367
35580119,43,25,1,29,1,1,100,75,56.14035087719298
35580144,0,44,0,0,1,0,45,2.2222222222222254,2.2222222222222254
35580156,25,16,2,19,0,0,62,74.19354838709677,56.75675675675676
35580193,95,120,10,41,2,0,268,55.223880597014926,30.63583815028902
35580247,55,21,2,19,0,0,97,78.35051546391753,50
35580260,67,75,10,23,1,0,176,57.38636363636363,31.19266055045872
35580338,19,27,2,43,0,0,91,70.32967032967032,62.5
35580348,48,47,2,23,0,0,120,60.83333333333334,34.72222222222222
35580351,67,21,2,13,1,0,104,79.8076923076923,43.24324324324324
35580375,67,27,0,0,0,0,94,71.27659574468085,0
35580387,70,33,1,35,1,0,140,76.42857142857142,52.85714285714286
35580399,74,27,1,14,1,0,117,76.92307692307692,37.2093023255814
35580405,59,36,4,39,0,0,138,73.91304347826086,54.43037974683544
35580454,53,11,1,8,1,0,74,85.13513513513513,47.61904761904761
35580582,29,41,6,22,0,0,98,58.16326530612245,40.57971014492754
35580594,52,14,1,11,2,0,80,82.5,50
35580661,109,49,5,20,1,0,184,73.36956521739131,34.66666666666667
35580685,145,38,2,17,1,1,204,81.37254901960785,35.59322033898306
35580703,10,53,7,92,1,1,164,67.68292682926828,65.5844155844156
35580715,0,45,3,22,0,0,70,35.71428571428571,35.71428571428571
35580727,67,193,19,104,2,2,387,50.12919896640826,39.6875
35580739,221,262,16,131,0,0,630,58.412698412698404,35.94132029339854
35580806,3,43,0,2,0,0,48,10.416666666666663,4.444444444444439
35580818,54,41,2,9,0,0,106,61.32075471698113,21.153846153846157
35580831,69,56,4,66,1,1,197,71.57360406091371,56.25
35580855,63,45,3,17,0,0,128,64.84375,30.76923076923077
35580867,13,26,3,15,0,0,57,54.385964912280706,40.90909090909091
35580909,30,17,2,19,0,0,68,75,55.263157894736835
35580922,95,14,1,17,3,1,131,89.31297709923665,61.111111111111114
35580934,47,17,2,8,0,0,74,77.02702702702703,37.03703703703704
35580983,52,26,3,9,4,2,96,72.91666666666667,40.90909090909091
35581008,64,43,3,13,0,0,123,65.04065040650406,27.118644067796616
35581012,83,17,1,6,1,0,108,84.25925925925925,31.999999999999996
35581033,59,10,1,9,0,0,79,87.34177215189874,50
35581057,101,33,2,21,0,0,157,78.98089171974523,41.07142857142857
35581069,44,15,1,20,0,0,80,81.25,58.33333333333333
35581070,39,17,0,13,0,0,69,75.36231884057972,43.333333333333336
35581100,78,43,1,64,0,0,186,76.88172043010752,60.18518518518518
35581112,35,7,0,1,0,0,43,83.72093023255813,12.5
35581161,0,60,3,49,1,0,113,46.90265486725663,46.90265486725663
35581173,132,24,1,10,0,0,167,85.62874251497006,31.428571428571427
35581197,46,20,1,8,0,0,75,73.33333333333334,31.034482758620683
35581276,53,40,0,3,0,0,96,58.33333333333333,6.976744186046513
35581306,62,14,0,17,1,0,94,85.1063829787234,56.25
35581318,3,41,7,36,1,0,88,53.40909090909092,51.764705882352935
35581537,692,281,507,441,0,2,1923,85.38741549661987,77.17303005686433
35581574,80,53,15,49,1,0,198,73.23232323232322,55.08474576271186
35581604,86,34,1,8,1,0,130,73.84615384615385,22.72727272727273
35581636,53,31,3,45,0,0,132,76.51515151515152,60.75949367088608
35581677,32,18,2,6,0,0,58,68.96551724137932,30.76923076923077
35581720,170,59,3,56,0,1,289,79.58477508650519,50.42016806722689
35581756,42,20,2,23,0,0,87,77.01149425287358,55.55555555555556
35581773,35,16,3,26,0,0,80,80,64.44444444444444
35581884,25,23,0,28,0,0,76,69.73684210526316,54.90196078431373
35581951,57,47,5,13,5,0,127,62.99212598425197,32.85714285714286
35581963,73,20,6,13,0,0,112,82.14285714285714,48.71794871794872
35582037,162,99,9,114,2,0,386,74.35233160621762,55.80357142857143
35582098,28,51,5,51,0,0,135,62.22222222222222,52.33644859813084
35582128,40,19,2,17,0,0,78,75.64102564102564,50
35582136,93,46,1,43,1,0,184,75,49.45054945054945
35582165,143,243,26,238,3,0,653,62.78713629402757,52.352941176470594
35582207,137,32,5,26,1,0,201,84.07960199004975,50
35582232,82,21,1,7,0,0,111,81.08108108108108,27.586206896551722
35582273,51,34,6,5,0,0,96,64.58333333333333,24.444444444444446
35582300,28,34,5,22,0,0,89,61.79775280898876,44.26229508196722
35582402,43,22,1,11,0,0,77,71.42857142857143,35.29411764705882
35582499,173,38,0,14,0,0,225,83.11111111111111,26.923076923076927
35582505,75,35,7,34,0,0,151,76.82119205298014,53.94736842105263
35582529,51,14,8,23,0,0,96,85.41666666666666,68.88888888888889
35582633,48,77,2,113,0,0,240,67.91666666666667,59.89583333333333
35582712,86,13,0,33,0,0,132,90.15151515151516,71.73913043478262
35582724,35,77,4,36,0,0,152,49.3421052631579,34.18803418803419
35582736,79,51,0,9,1,0,140,63.57142857142857,16.393442622950815
35582748,2,51,0,3,0,0,56,8.92857142857143,5.555555555555558
35582759,115,74,3,20,1,0,213,65.25821596244131,24.489795918367353
35582815,46,65,3,9,2,0,125,48,17.721518987341767
35582840,112,7,0,1,13,0,133,94.73684210526316,66.66666666666667
35582852,5,50,0,5,0,0,60,16.666666666666664,9.090909090909093
35582888,34,22,3,21,0,0,80,72.5,52.17391304347826
35582897,0,72,2,3,7,0,84,14.28571428571429,14.28571428571429
35582906,4,104,2,26,4,0,140,25.71428571428571,23.529411764705888
35582918,4,34,1,11,0,0,50,31.999999999999996,26.086956521739136
35582931,100,66,3,38,3,0,210,68.57142857142857,40
35582980,4,35,2,10,3,0,54,35.18518518518518,30.000000000000004
35583005,117,267,0,3,31,0,418,36.1244019138756,11.29568106312292
35583029,74,29,2,11,0,0,116,75,30.952380952380953
35583030,168,68,2,34,0,0,272,75,34.61538461538461
35583042,60,81,10,45,1,0,197,58.88324873096447,40.87591240875912
35583054,91,51,6,20,0,0,168,69.64285714285714,33.76623376623377
35583108,68,41,3,29,1,0,142,71.12676056338027,44.5945945945946
35583121,6,24,0,14,0,0,44,45.45454545454546,36.8421052631579
35583133,38,94,4,10,3,0,149,36.91275167785235,15.315315315315313
35583194,122,91,6,36,1,0,256,64.453125,32.08955223880597
35583212,44,13,3,9,1,0,70,81.42857142857143,50
35583261,18,125,1,0,0,0,144,13.194444444444443,0.7936507936507908
35583273,150,23,1,27,0,0,201,88.55721393034825,54.90196078431373
35583315,18,61,4,31,1,2,117,47.86324786324786,38.38383838383839
35583327,75,31,3,9,0,0,118,73.72881355932203,27.906976744186053
35583492,43,18,2,12,0,0,75,76,43.75
35583509,6,63,3,1,2,0,75,16.000000000000004,8.695652173913048
35583522,2,55,0,0,2,0,59,6.779661016949157,3.508771929824561
35583558,92,81,11,115,1,0,300,73,61.057692307692314
35583601,66,31,3,11,0,0,111,72.07207207207207,31.11111111111111
35583728,60,29,3,12,1,0,105,72.38095238095238,35.55555555555555
35583832,131,49,1,39,0,0,220,77.72727272727273,44.9438202247191
35583947,76,20,1,18,0,0,115,82.6086956521739,48.71794871794872
35584010,1,34,1,42,0,0,78,56.41025641025641,55.84415584415585
35584034,35,26,1,44,0,2,108,75.92592592592592,64.38356164383562
35584061,48,27,2,7,0,1,85,68.23529411764706,27.027027027027028
35584125,34,11,3,21,0,0,69,84.05797101449275,68.57142857142857
35584198,112,77,4,49,1,0,243,68.3127572016461,41.221374045801525
35584216,77,17,3,26,1,0,124,86.29032258064517,63.829787234042556
35584228,9,49,7,81,0,0,146,66.43835616438356,64.23357664233576
35584236,60,27,3,41,0,0,131,79.38931297709924,61.9718309859155
35584241,71,24,3,23,0,0,121,80.16528925619835,52
35584253,146,146,12,113,1,0,418,65.07177033492823,46.32352941176471
35584289,93,28,2,10,1,0,134,79.10447761194031,31.707317073170728
35584290,92,30,0,28,0,0,150,80,48.275862068965516
35584307,61,16,1,25,0,1,104,84.61538461538461,62.7906976744186
35584356,90,36,4,69,0,0,199,81.90954773869346,66.97247706422019
35584381,32,15,1,12,0,0,60,75,46.42857142857143
35584423,65,25,3,21,0,0,114,78.0701754385965,48.97959183673469
35584435,149,61,5,20,2,1,238,74.36974789915966,31.46067415730337
35584447,141,75,6,66,0,0,288,73.95833333333333,48.97959183673469
35584496,41,52,4,43,0,0,140,62.857142857142854,47.47474747474747
35584538,31,10,0,29,0,0,70,85.71428571428572,74.35897435897436
35584551,10,27,0,17,1,0,55,50.90909090909091,40
35584575,73,13,2,20,1,1,110,88.18181818181819,64.86486486486487
35584587,80,42,6,112,0,0,240,82.5,73.75
35584599,38,44,6,87,0,0,175,74.85714285714286,67.88321167883211
35584666,149,68,1,23,0,0,241,71.78423236514523,26.086956521739136
35584678,60,25,2,11,0,0,98,74.48979591836735,34.210526315789465
35584685,68,42,6,37,0,1,154,72.72727272727273,51.162790697674424
35584691,161,47,1,60,0,0,269,82.5278810408922,56.48148148148149
35584708,144,47,1,106,0,0,298,84.2281879194631,69.48051948051948
35584757,76,21,2,17,0,0,116,81.89655172413794,47.5
35584794,53,16,1,23,0,1,94,82.97872340425532,60.97560975609756
35584800,55,18,0,6,0,0,79,77.21518987341773,25
35584812,124,43,6,26,1,0,200,78.5,43.42105263157895
35584824,26,28,1,20,1,0,76,63.1578947368421,43.99999999999999
35584836,10,32,2,45,0,0,89,64.04494382022472,59.493670886075954
35584861,20,18,9,20,0,0,67,73.13432835820896,61.702127659574465
35584885,110,28,8,21,0,0,167,83.23353293413174,50.877192982456144
35584903,239,79,7,163,0,1,489,83.84458077709611,68.39999999999999
35584915,554,130,18,124,0,1,827,84.28053204353083,52.38095238095239
35584940,53,10,0,7,0,0,70,85.71428571428572,41.17647058823529
35584976,3,43,0,4,0,0,50,14.000000000000002,8.510638297872342
35585048,272,142,19,191,0,0,624,77.24358974358975,59.65909090909092
35585361,386,170,15,230,4,0,805,78.88198757763976,59.427207637231504
35585397,0,47,0,2,0,0,49,4.081632653061229,4.081632653061229
35585497,319,165,9,322,0,0,815,79.75460122699387,66.73387096774194
35585555,60,31,2,25,1,0,119,73.94957983193278,47.45762711864406
35585579,39,52,5,29,0,0,125,58.400000000000006,39.53488372093024
35585622,14,150,2,8,1,1,176,14.77272727272727,7.4074074074074066
35585749,3,28,3,30,0,0,64,56.25,54.0983606557377
35585750,5,59,1,61,0,0,126,53.17460317460318,51.23966942148761
35585762,53,32,7,46,0,0,138,76.81159420289855,62.35294117647059
35585774,36,25,4,41,0,1,107,76.63551401869158,64.7887323943662
35585828,36,18,2,23,0,0,79,77.21518987341773,58.13953488372092
35585836,33,29,2,14,0,2,80,63.74999999999999,38.297872340425535
35585853,272,38,3,96,0,1,410,90.73170731707317,72.46376811594203
35585907,54,18,3,19,0,0,94,80.85106382978724,55.00000000000001
35585919,65,65,4,69,1,0,204,68.13725490196079,53.23741007194245
35585981,113,57,5,77,3,0,255,77.64705882352942,59.859154929577464
35585993,112,16,1,26,0,0,155,89.6774193548387,62.7906976744186
35586024,77,22,2,10,1,0,112,80.35714285714286,37.142857142857146
35586031,31,35,1,25,0,0,92,61.95652173913043,42.622950819672134
35586080,29,24,2,15,1,0,71,66.19718309859155,42.85714285714286
35586110,118,63,7,37,1,0,226,72.12389380530973,41.666666666666664
35586183,49,35,2,1,1,0,88,60.22727272727273,10.256410256410254
35586298,72,22,2,30,8,0,134,83.5820895522388,64.51612903225806
35586336,35,21,1,10,1,0,68,69.11764705882352,36.36363636363637
35586341,58,27,2,24,0,0,111,75.67567567567568,49.056603773584904
35586420,35,17,0,14,0,0,66,74.24242424242425,45.16129032258065
35586444,73,44,9,33,0,0,159,72.32704402515724,48.837209302325576
35586456,125,26,1,47,0,0,199,86.93467336683418,64.86486486486487
35586481,1,54,1,7,2,0,65,16.92307692307692,15.625
35586547,47,217,31,223,0,0,518,58.10810810810811,53.92781316348195
35586560,55,21,3,12,1,0,92,77.17391304347827,43.24324324324324
35586596,51,63,6,101,0,0,221,71.49321266968326,62.94117647058823
35586648,37,17,1,19,1,0,75,77.33333333333333,55.263157894736835
35586651,68,33,6,31,0,0,138,76.08695652173914,52.85714285714286
35586675,75,82,7,73,0,1,238,65.54621848739495,49.693251533742334
35586717,6,33,4,30,0,0,73,54.794520547945204,50.74626865671642
35586729,33,23,2,19,0,0,77,70.12987012987013,47.72727272727273
35586730,28,31,6,30,0,0,95,67.36842105263158,53.73134328358209
35586742,44,84,0,1,0,0,129,34.883720930232556,1.17647058823529
35586791,39,23,1,16,1,0,80,71.25,43.90243902439024
35586821,1,68,0,1,3,0,73,6.849315068493156,5.555555555555558
35586870,61,35,2,14,0,0,112,68.75,31.372549019607842
35586912,60,17,1,16,0,1,95,82.10526315789474,51.42857142857142
35586924,2,32,8,50,0,0,92,65.21739130434783,64.44444444444444
35586961,1,42,0,0,0,0,43,2.3255813953488413,0
35586985,91,29,11,59,3,0,193,84.97409326424871,71.56862745098039
35586997,390,125,9,194,0,0,718,82.59052924791087,61.890243902439025
35587035,0,49,8,35,0,0,92,46.7391304347826,46.7391304347826
35587102,36,13,3,14,0,0,66,80.3030303030303,56.666666666666664
35587163,82,267,33,305,1,0,688,61.19186046511628,55.940594059405946
35587229,68,33,4,15,0,0,120,72.5,36.53846153846154
35587278,45,4,0,0,0,0,49,91.83673469387756,0
35587345,52,32,7,22,0,0,113,71.68141592920354,47.540983606557376
35587369,22,23,4,51,0,0,100,77,70.51282051282051
35587370,57,24,2,9,0,0,92,73.91304347826086,31.428571428571427
35587448,22,46,6,43,0,0,117,60.68376068376069,51.578947368421055
35587497,42,14,1,10,0,0,67,79.10447761194031,43.99999999999999
35587503,120,52,2,28,0,0,202,74.25742574257426,36.58536585365854
35587527,3,127,1,1,0,0,132,3.7878787878787845,1.5503875968992276
35587539,321,129,7,134,1,3,595,78.31932773109244,52.919708029197075
35587679,151,157,8,184,1,0,501,68.66267465069859,55.14285714285714
35587771,214,70,15,73,1,1,374,81.28342245989305,56.25
35587783,7,66,0,4,0,0,77,14.28571428571429,5.714285714285716
35587813,43,15,3,17,0,0,78,80.76923076923077,57.14285714285714
35587936,53,20,2,8,0,0,83,75.90361445783132,33.333333333333336
35588040,85,28,3,36,0,0,152,81.57894736842105,58.2089552238806
35588052,60,22,1,11,0,0,94,76.59574468085107,35.29411764705882
35800089,510,379,6,53,5,0,953,60.230849947534104,14.446952595936791
35800090,202,158,1,34,0,0,395,60,18.134715025906733
35800132,23,63,4,21,1,0,112,43.75,29.21348314606742
35800193,226,267,9,21,4,0,527,49.335863377609115,11.29568106312292
35800211,87,152,6,150,1,0,396,61.61616161616161,50.809061488673144
35800284,60,150,3,24,0,0,237,36.70886075949367,15.254237288135597
35800296,18,101,0,2,24,0,145,30.3448275862069,20.472440944881885
35800612,233,280,10,10,15,0,548,48.90510948905109,11.111111111111116
35800661,17,66,1,3,0,0,87,24.13793103448276,5.714285714285716
35800673,6,30,0,3,2,0,41,26.82926829268293,14.28571428571429
35800685,0,41,0,0,0,0,41,0,0
35800715,18,290,0,5,11,0,324,10.49382716049383,5.228758169934644
35800788,67,48,0,0,2,0,117,58.97435897435898,4.0000000000000036
35800797,50,1,0,1,0,0,52,98.07692307692307,50
35800843,17,19,2,4,0,0,42,54.761904761904766,24
35800855,2,79,0,0,3,0,84,5.952380952380953,3.658536585365857
35800880,1,44,1,4,0,0,50,12,10.204081632653061
35800892,12,59,0,0,1,0,72,18.055555555555557,1.6666666666666718
35800946,1,49,0,10,1,0,61,19.672131147540984,18.333333333333336
35800971,163,232,14,68,2,0,479,51.56576200417536,26.582278481012654
35801008,44,54,0,7,0,0,105,48.57142857142858,11.475409836065575
35801012,51,39,4,12,0,0,106,63.20754716981132,29.09090909090909
35801033,16,69,1,31,0,0,117,41.02564102564102,31.68316831683168
35801057,41,51,3,11,0,0,106,51.886792452830186,21.53846153846154
35801070,29,77,2,5,0,0,113,31.85840707964602,8.333333333333337
35801100,10,60,0,8,0,0,78,23.076923076923073,11.764705882352944
35801159,9,32,0,1,0,0,42,23.809523809523814,3.0303030303030276
35801185,119,6,1,0,0,0,126,95.23809523809523,14.28571428571429
35801197,24,58,0,5,2,0,89,34.8314606741573,10.769230769230765
35801239,16,28,0,4,0,0,48,41.666666666666664,12.5
35801252,16,125,1,9,0,0,151,17.218543046357617,7.4074074074074066
35801306,7,92,0,0,0,0,99,7.070707070707072,0
35801380,114,140,11,42,2,3,312,55.12820512820513,29.292929292929294
35801434,84,22,3,8,0,1,118,81.35593220338984,35.29411764705882
35801458,110,248,15,93,2,0,468,47.008547008547005,30.72625698324022
35801537,14,52,1,5,0,0,72,27.77777777777778,10.344827586206895
35801773,35,110,0,0,3,0,148,25.67567567567568,2.6548672566371723
35802050,121,79,4,17,0,0,221,64.25339366515837,20.999999999999996
35802207,25,110,2,6,2,0,145,24.13793103448276,8.333333333333337
35802335,28,57,5,28,0,0,118,51.69491525423729,36.66666666666667
35802487,231,159,7,49,4,0,450,64.66666666666667,27.397260273972602
35802645,136,111,5,69,0,0,321,65.42056074766356,40
35802670,25,36,0,1,3,0,65,44.61538461538461,9.999999999999998
35802724,70,168,0,20,0,1,259,35.13513513513513,11.111111111111116
35802736,333,60,0,3,1,0,397,84.88664987405541,6.25
35802748,41,46,4,41,0,0,132,65.15151515151516,49.45054945054945
35802761,17,47,1,16,0,1,82,42.6829268292683,27.692307692307693
35802815,48,50,0,0,0,0,98,48.97959183673469,0
35803807,8,80,4,4,0,0,96,16.666666666666664,9.090909090909093
35803819,17,43,3,4,0,0,67,35.820895522388064,14.000000000000002
35805063,348,288,23,417,4,2,1082,73.38262476894639,60.76294277929155
35805427,14,34,3,4,0,0,55,38.18181818181819,17.07317073170732
35805439,247,150,4,19,1,0,421,64.37054631828978,13.793103448275868
35805440,258,122,7,37,0,0,424,71.22641509433963,26.506024096385538
35805452,394,260,12,80,6,2,754,65.51724137931035,27.77777777777778
35805464,73,116,2,11,2,0,204,43.13725490196079,11.45038167938931
35805476,160,63,1,19,0,0,243,74.07407407407408,24.096385542168676
35805567,219,369,9,27,1,0,625,40.959999999999994,9.113300492610843
35805580,31,64,0,17,0,0,112,42.85714285714286,20.98765432098766
35806146,85,74,1,16,0,0,176,57.95454545454546,18.681318681318682
35806286,785,426,27,126,3,3,1370,68.9051094890511,27.179487179487182
35806298,165,179,3,61,2,0,410,56.34146341463415,26.93877551020408
35806304,367,183,13,64,0,1,628,70.85987261146497,29.885057471264364
35806316,251,270,20,87,0,0,628,57.00636942675159,28.381962864721487
35806328,14,55,3,3,0,0,75,26.66666666666667,9.836065573770492
35806341,14,73,1,20,1,0,109,33.02752293577982,23.15789473684211
35806419,127,155,6,43,0,0,331,53.17220543806647,24.01960784313726
35806420,205,345,15,94,4,0,663,47.96380090497737,24.672489082969427
35806432,119,122,4,33,1,0,279,56.272401433691755,23.750000000000004
35806444,86,218,8,15,89,0,416,47.59615384615385,33.93939393939394
35806456,28,134,6,27,2,0,197,31.979695431472077,20.710059171597628
35806626,47,18,1,24,0,0,90,80,58.13953488372092
35806651,61,19,1,27,0,0,108,82.4074074074074,59.57446808510638
35806742,53,60,8,37,1,0,159,62.264150943396224,43.39622641509434
35806821,13,37,5,9,0,0,64,42.1875,27.450980392156865
35806857,21,17,5,63,1,0,107,84.11214953271028,80.23255813953489
35806882,16,29,3,2,2,0,52,44.230769230769226,19.444444444444443
35806900,13,51,0,9,1,0,74,31.081081081081084,16.393442622950815
35806912,66,38,7,27,2,0,140,72.85714285714286,48.64864864864865
35806924,78,26,4,29,0,0,137,81.02189781021897,55.93220338983051
35806948,159,39,3,15,0,0,216,81.94444444444444,31.57894736842105
35806961,49,20,0,11,0,0,80,75,35.483870967741936
35806973,47,18,2,13,1,0,81,77.77777777777779,47.05882352941176
35806997,49,23,5,17,0,0,94,75.53191489361703,48.88888888888889
35807023,3,48,0,2,0,0,53,9.433962264150942,4.0000000000000036
35807035,18,23,2,0,0,0,43,46.51162790697675,7.9999999999999964
35807114,0,66,0,4,0,0,70,5.714285714285716,5.714285714285716
35807138,38,24,0,15,0,0,77,68.83116883116884,38.46153846153846
35807148,93,35,5,22,1,0,156,77.56410256410257,44.44444444444444
35807266,1,41,0,2,0,0,44,6.818181818181824,4.651162790697672
35807278,16,52,3,2,1,0,74,29.729729729729726,10.344827586206895
35807285,78,3,0,0,0,0,81,96.2962962962963,0
35807333,50,63,4,30,1,0,148,57.432432432432435,35.71428571428571
35807345,77,22,3,13,0,0,115,80.8695652173913,42.10526315789473
35807370,123,37,3,46,0,0,209,82.29665071770334,56.97674418604651
35807394,98,36,3,8,0,0,145,75.17241379310344,23.404255319148938
35807400,62,61,2,25,0,0,150,59.33333333333333,30.681818181818176
35807618,95,159,3,9,7,0,273,41.75824175824175,10.67415730337079
35807709,80,24,2,8,0,0,114,78.94736842105263,29.411764705882348
35807710,37,25,5,58,0,0,125,80,71.59090909090908
35807758,98,74,3,21,1,0,197,62.43654822335025,25.25252525252525
35807771,101,240,8,76,7,0,432,44.44444444444444,27.49244712990937
35807813,119,882,9,30,13,0,1053,16.23931623931624,5.567451820128477
35807825,631,227,19,202,1,0,1080,78.98148148148148,49.44320712694877
35808003,145,195,4,37,0,0,381,48.818897637795274,17.3728813559322
35808088,36,84,4,19,0,0,143,41.25874125874126,21.495327102803742
35808209,65,56,1,18,0,1,141,60.28368794326241,26.315789473684216
35808210,418,387,4,69,1,1,880,56.02272727272728,16.233766233766232
35808222,58,74,8,53,0,0,193,61.6580310880829,45.18518518518518
35808301,463,985,33,98,19,0,1598,38.360450563204004,13.215859030837008
35808593,29,56,4,18,3,0,110,49.09090909090909,30.864197530864203
35808647,17,30,0,2,2,0,51,41.17647058823529,11.764705882352944
35808659,23,84,2,27,1,0,137,38.68613138686131,26.315789473684216
35809287,518,496,3,10,9,0,1036,52.12355212355213,4.24710424710425
35809305,111,440,9,65,15,0,640,31.25,16.824196597353502
35809482,48,72,1,14,2,0,137,47.44525547445255,19.10112359550562
35809573,7,64,1,2,0,0,74,13.513513513513509,4.477611940298509
35809585,50,24,3,5,0,0,82,70.73170731707317,25
35809676,362,971,23,104,6,2,1468,33.855585831062676,12.20614828209765
35809688,209,337,11,64,3,2,626,46.166134185303505,19.18465227817746
35809706,55,201,5,36,3,0,300,32.99999999999999,17.959183673469393
35810046,111,124,8,45,0,0,288,56.94444444444444,29.943502824858758
35810058,124,159,0,5,2,0,290,45.17241379310345,4.216867469879515
35810307,96,648,9,34,3,0,790,17.974683544303794,6.628242074927959
35810538,508,406,24,152,1,1,1092,62.82051282051282,30.47945205479452
35810548,139,121,2,7,0,0,269,55.01858736059479,6.923076923076921
35810551,160,171,3,12,0,1,347,50.720461095100866,8.556149732620321
35810617,176,180,5,16,6,0,383,53.00261096605744,13.043478260869568
35810629,22,33,1,17,0,0,73,54.794520547945204,35.29411764705882
35810630,350,107,3,47,1,0,508,78.93700787401575,32.27848101265823
35810654,108,92,4,131,0,1,336,72.61904761904762,59.64912280701755
35811105,126,133,3,24,3,2,291,54.295532646048116,19.393939393939398
35811385,157,223,4,20,9,1,414,46.135265700483096,13.229571984435795
35811397,41,68,4,11,1,0,125,45.599999999999994,19.047619047619047
35811658,73,198,12,38,6,0,327,39.449541284403665,22.047244094488192
35811725,49,36,5,41,0,0,131,72.51908396946564,56.09756097560976
35811798,65,21,3,21,0,0,110,80.9090909090909,53.333333333333336
35811816,270,105,2,32,0,0,409,74.32762836185819,24.460431654676263
35811890,20,31,1,17,0,0,69,55.072463768115945,36.73469387755102
35811919,59,29,5,24,0,0,117,75.21367521367522,50
35812353,7,46,1,2,1,0,57,19.298245614035093,7.9999999999999964
35812390,20,54,4,10,1,0,89,39.32584269662921,21.739130434782606
35812481,92,20,0,4,0,0,116,82.75862068965517,16.666666666666664
35812602,6,35,0,2,0,0,43,18.6046511627907,5.405405405405405
35812687,136,114,6,20,0,0,276,58.69565217391304,18.571428571428573
35812729,2,44,0,15,0,0,61,27.86885245901639,25.423728813559322
35812894,53,150,2,15,5,0,225,33.333333333333336,12.790697674418606
35812912,48,130,4,6,0,0,188,30.85106382978723,7.14285714285714
35812985,12,46,0,1,0,0,59,22.033898305084744,2.127659574468088
35813059,0,50,0,1,4,0,55,9.090909090909093,9.090909090909093
35813060,104,20,1,0,0,0,125,84,4.761904761904767
35813114,54,277,11,44,2,0,388,28.60824742268041,17.06586826347305
35813229,6,34,2,7,0,0,49,30.612244897959183,20.93023255813954
35813254,7,48,0,5,0,0,60,19.999999999999996,9.433962264150942
35813266,13,55,1,0,0,0,69,20.28985507246377,1.7857142857142905
35813278,35,44,4,8,0,0,91,51.64835164835164,21.42857142857143
35813291,48,4,0,8,0,0,60,93.33333333333333,66.66666666666667
35813321,133,43,1,23,1,0,201,78.60696517412936,36.76470588235294
35813436,3,21,3,25,0,0,52,59.61538461538461,57.14285714285714
35813485,8,41,0,15,0,0,64,35.9375,26.785714285714292
35813497,1,29,2,15,1,0,48,39.583333333333336,38.297872340425535
35813597,83,93,7,92,0,0,275,66.18181818181819,51.5625
35813643,21,49,1,19,0,0,90,45.55555555555556,28.985507246376805
35813710,0,60,2,18,0,0,80,25,25
35813734,42,13,0,12,0,0,67,80.59701492537313,48
35813746,63,25,1,9,1,0,99,74.74747474747474,30.555555555555557
35813783,23,32,1,12,1,0,69,53.623188405797094,30.434782608695656
35813837,45,101,9,12,2,0,169,40.23668639053254,18.54838709677419
35813953,2,21,1,23,0,0,47,55.319148936170215,53.333333333333336
35813977,59,21,6,75,0,0,161,86.95652173913044,79.41176470588236
35813989,68,36,5,21,0,0,130,72.3076923076923,41.93548387096774
35814003,0,48,0,0,2,0,50,4.0000000000000036,4.0000000000000036
35814015,127,50,1,137,1,0,316,84.17721518987342,73.54497354497354
35814040,44,20,2,33,0,0,99,79.7979797979798,63.63636363636363
35814131,9,237,1,0,0,0,247,4.048582995951422,0.42016806722688926
35814180,105,15,0,5,0,0,125,88,25
35814209,27,28,0,3,0,0,58,51.72413793103448,9.677419354838712
35814234,59,61,0,0,1,0,121,49.586776859504134,1.6129032258064502
35814258,29,21,7,14,0,0,71,70.4225352112676,50
35814271,43,23,1,7,1,0,75,69.33333333333334,28.125
35814283,36,38,4,30,1,0,109,65.13761467889908,47.945205479452056
35814295,80,20,1,27,0,0,128,84.375,58.33333333333333
35814325,1,35,3,20,0,0,59,40.67796610169492,39.6551724137931
35814337,65,26,3,12,0,0,106,75.47169811320755,36.58536585365854
35814350,5,32,5,84,0,1,127,74.80314960629921,73.77049180327869
35814386,36,29,1,4,1,1,72,59.72222222222222,19.444444444444443
35900060,570,411,37,309,1,3,1331,69.12096168294515,45.99211563731932
35900102,42,446,43,306,1,1,839,46.841477949940405,44.04015056461732
35901672,135,208,6,74,0,0,423,50.82742316784869,27.77777777777778
35901684,274,430,39,336,1,0,1080,60.18518518518518,46.650124069478906
35901702,266,601,44,279,4,1,1195,49.7071129707113,35.30678148546824
35901714,170,304,28,129,2,1,634,52.05047318611987,34.48275862068966
35901726,398,475,67,545,4,2,1491,68.1421864520456,56.54162854528819
35901738,277,169,14,113,0,0,573,70.50610820244327,42.9054054054054
35901748,317,303,29,229,4,0,882,65.64625850340136,46.3716814159292
35901751,229,349,39,415,0,4,1036,66.31274131274132,56.753407682775716
35901763,328,278,32,165,3,1,807,65.55142503097893,41.962421711899786
35901775,195,83,13,99,0,1,391,78.77237851662404,57.65306122448979
35901787,189,173,17,166,0,0,545,68.25688073394495,51.40449438202247
35901799,346,179,15,168,1,2,711,74.82419127988749,50.95890410958904
35902226,183,497,47,290,1,2,1020,51.27450980392156,40.62126642771804
35902238,163,84,6,55,1,0,309,72.81553398058253,42.465753424657535
35902248,314,168,12,73,0,0,567,70.37037037037037,33.596837944664024
35902263,414,494,78,566,6,7,1565,68.43450479233226,57.08079930495222
35902287,513,582,52,574,5,1,1727,66.29994209612045,52.05930807248764
35902299,344,245,25,292,2,0,908,73.01762114537445,56.560283687943254
35902305,300,430,35,324,2,1,1092,60.62271062271063,45.707070707070706
35902500,515,555,81,489,2,5,1647,66.3023679417122,50.97173144876326
35902512,185,633,50,527,1,1,1397,54.68861846814603,47.77227722772277
35902524,194,80,12,193,0,0,479,83.29853862212944,71.9298245614035
35902536,228,231,29,245,2,0,735,68.57142857142857,54.437869822485204
35902573,258,452,40,316,4,1,1071,57.79645191409897,44.40344403444034
35902585,313,86,13,62,0,0,474,81.85654008438819,46.58385093167702
35902597,671,458,28,440,4,1,1602,71.4107365792759,50.805585392051555
35902603,747,272,30,217,0,5,1271,78.59952793076317,48.091603053435115
35902615,452,482,40,393,0,3,1370,64.81751824817519,47.494553376906325
35902627,441,437,78,353,1,0,1310,66.6412213740458,49.712313003452245
35902639,602,708,42,430,5,0,1787,60.38052602126469,40.25316455696203
35902640,271,132,14,101,1,0,519,74.56647398843931,46.7741935483871
35902664,201,190,33,194,0,0,618,69.25566343042071,54.43645083932853
35902718,106,91,4,56,1,0,258,64.72868217054264,40.13157894736842
35902724,487,252,45,189,1,1,975,74.15384615384615,48.36065573770492
35902780,360,200,18,185,0,0,763,73.78768020969856,50.37220843672456
35902792,181,146,5,113,1,0,446,67.26457399103138,44.905660377358494
35902809,309,390,59,285,1,0,1044,62.643678160919535,46.93877551020408
35902810,370,171,12,148,0,1,702,75.64102564102564,48.49397590361446
35902822,205,184,19,182,0,1,591,68.8663282571912,52.33160621761659
35902834,229,383,35,269,2,3,921,58.414766558089035,44.653179190751445
35902846,746,287,26,240,1,0,1300,77.92307692307692,48.19494584837545
35902858,148,85,9,72,0,1,315,73.01587301587303,49.101796407185624
35902861,355,379,29,292,1,0,1056,64.10984848484848,45.93437945791726
35902871,403,289,44,390,1,0,1127,74.3566992014197,60.0828729281768
35902883,406,337,30,173,0,0,946,64.37632135306555,37.59259259259259
35902895,523,317,21,181,6,1,1049,69.78074356530028,39.73384030418251
35902901,588,350,34,431,3,1,1407,75.12437810945273,57.26495726495726
35902913,443,552,70,652,2,1,1720,67.90697674418604,56.77368833202819
35902925,474,720,41,382,8,4,1629,55.80110497237569,37.66233766233766
35904173,298,420,54,365,1,0,1138,63.09314586994728,50
35904247,89,336,35,241,0,1,702,52.13675213675213,45.18760195758564
35904259,198,352,18,246,2,1,817,56.91554467564259,43.134087237479804
35904260,203,119,14,99,0,0,435,72.64367816091955,48.706896551724135
35904272,69,131,10,78,1,1,290,54.82758620689655,40.723981900452486
35904284,335,334,54,256,1,2,982,65.9877800407332,48.377125193199376
35904296,327,330,55,292,3,5,1012,67.3913043478261,51.82481751824817
35904302,613,483,66,351,3,3,1519,68.20276497695852,46.68874172185431
35904314,139,154,25,206,0,0,524,70.61068702290076,60
35904326,284,468,20,199,2,0,973,51.90133607399794,32.07547169811321
35904338,141,147,14,112,0,0,414,64.4927536231884,46.15384615384615
35904348,328,360,38,235,0,1,962,62.57796257796257,43.217665615141954
35904569,540,199,24,129,3,1,896,77.79017857142857,44.10112359550562
35904582,344,350,44,212,1,1,952,63.23529411764706,42.43421052631579
35904594,607,678,71,754,2,3,2115,67.94326241134752,55.03978779840849
35904624,170,263,16,142,1,0,592,55.57432432432432,37.67772511848341
35904636,431,62,5,96,1,0,595,89.57983193277312,62.19512195121951
35904648,420,211,16,141,0,0,788,73.22335025380711,42.66304347826087
35904824,444,194,12,241,0,0,891,78.22671156004489,56.59955257270693
35904867,254,126,18,104,2,0,504,75,49.6
35904879,597,413,38,482,1,3,1534,73.07692307692308,55.92315901814301
35904922,306,120,26,95,0,0,547,78.06215722120659,50.20746887966805
35906141,382,288,44,254,1,2,971,70.33985581874356,51.103565365025474
35906153,579,447,22,292,3,3,1346,66.79049034175335,41.720990873533246
35906165,905,428,48,429,3,3,1816,76.43171806167402,53.018660812294186
35906177,196,66,10,66,0,2,340,80.58823529411765,54.16666666666667
35906189,269,124,18,178,0,0,589,78.94736842105263,61.25000000000001
35906190,126,257,26,177,1,1,588,56.292517006802726,44.37229437229438
35906207,59,108,15,53,0,0,235,54.04255319148936,38.63636363636363
35906529,256,206,27,132,1,0,622,66.88102893890675,43.715846994535525
35906530,25,363,99,648,0,1,1136,68.04577464788733,67.32673267326732
35906542,463,310,32,255,1,3,1064,70.86466165413535,48.41930116472546
35906554,429,244,20,316,1,1,1011,75.86547972304649,58.07560137457044
35906566,652,335,34,370,4,1,1396,76.00286532951289,54.9731182795699
35906578,210,182,16,183,1,0,592,69.25675675675676,52.35602094240838
35906585,338,166,18,124,1,1,648,74.38271604938271,46.4516129032258
35906591,282,224,26,271,1,1,805,72.17391304347827,57.17017208413002
35906797,75,163,15,111,6,1,371,56.06469002695418,44.932432432432435
35906803,192,332,40,143,1,0,708,53.10734463276836,35.65891472868217
35906955,361,108,6,169,2,0,646,83.28173374613004,62.10526315789473
35906967,81,141,20,105,0,0,347,59.36599423631124,46.99248120300752
35906980,226,635,71,317,3,1,1253,49.32162809257782,38.169425511197666
35907005,565,214,26,176,3,2,986,78.29614604462475,49.16864608076009
35907017,447,476,233,514,0,7,1677,71.6159809183065,61.300813008130085
35907029,464,166,8,222,2,1,863,80.76477404403244,58.39598997493734
35907108,218,615,59,474,2,0,1368,55.04385964912281,46.52173913043478
35907112,367,594,42,258,2,3,1266,53.08056872037914,33.9265850945495
35907157,176,494,59,533,5,0,1267,61.010260457774265,54.72043996333639
35907194,315,527,42,387,2,2,1275,58.666666666666664,45.104166666666664
35907637,295,572,36,337,7,4,1251,54.2765787370104,40.16736401673641
35908368,673,370,54,441,1,2,1541,75.98961713173264,57.373271889400925
35908373,246,569,60,438,5,2,1320,56.8939393939394,47.02048417132217
35908400,378,346,28,184,2,0,938,63.113006396588474,38.21428571428571
35908782,215,247,23,179,0,0,664,62.80120481927711,44.98886414253897
35908848,231,360,27,284,1,0,903,60.13289036544851,46.42857142857143
35908939,180,222,5,104,1,2,514,56.809338521400775,33.532934131736525
35908940,351,269,9,102,1,0,732,63.25136612021858,29.396325459317584
35908952,275,162,19,144,1,0,601,73.04492512479202,50.306748466257666
35908964,192,244,18,232,1,3,690,64.6376811594203,51.00401606425703
35908997,285,103,8,41,1,2,440,76.5909090909091,33.54838709677419
35909002,147,180,18,95,1,0,441,59.183673469387756,38.775510204081634
35909014,304,321,12,94,1,0,732,56.14754098360656,25
35909026,171,137,7,90,2,0,407,66.33906633906635,41.94915254237288
35909038,474,39,3,31,0,0,547,92.87020109689213,46.57534246575342
35909048,394,161,10,91,1,1,658,75.53191489361703,39.015151515151516
35909051,217,419,26,173,1,1,837,49.94026284348865,32.41935483870968
35909063,242,50,6,32,1,0,331,84.89425981873111,43.82022471910112
35909075,361,396,22,221,1,0,1001,60.439560439560445,38.125
35909087,330,188,19,89,1,0,627,70.01594896331738,36.7003367003367
35909099,14,141,14,93,0,0,262,46.18320610687023,43.14516129032258
35909105,80,229,13,132,0,1,455,49.67032967032967,38.93333333333333
35909117,199,500,46,255,2,1,1003,50.14955134596211,37.810945273631845
35909129,144,166,33,147,0,1,491,66.19144602851324,52.1613832853026
35909130,179,522,33,214,1,1,950,45.05263157894737,32.295719844357976
35909154,912,61,19,68,0,2,1062,94.25612052730696,59.33333333333333
35909166,324,726,20,349,2,3,1424,49.01685393258427,34
35909178,571,171,17,175,0,0,934,81.6916488222698,52.892561983471076
35909185,372,140,16,120,1,0,649,78.42835130970724,49.45848375451264
35909191,305,268,23,221,0,3,820,67.3170731707317,47.961165048543684
35909208,333,220,15,199,0,0,767,71.31681877444589,49.30875576036866
35909212,93,279,66,320,1,0,759,63.24110671936759,58.10810810810811
35910259,229,424,31,304,4,2,994,57.3440643863179,44.57516339869281
35910260,262,165,15,110,1,0,553,70.1627486437613,43.29896907216495
35910272,449,352,27,384,2,1,1215,71.02880658436214,54.04699738903393
35910284,234,125,10,132,0,0,501,75.0499001996008,53.18352059925093
35910296,92,410,35,256,1,0,794,48.36272040302268,41.5954415954416
35910302,356,718,80,517,5,1,1677,57.18545020870602,45.64723694171082
35910326,463,215,22,192,1,0,893,75.92385218365062,50
35910338,269,384,44,332,4,2,1035,62.89855072463768,49.86945169712794
35910776,75,398,76,537,2,2,1090,63.486238532110086,60.78817733990147
35910788,239,309,27,312,2,2,891,65.31986531986533,52.60736196319018
35910797,584,330,45,251,4,0,1214,72.8171334431631,47.61904761904761
35910818,334,502,21,105,47,5,1014,50.4930966469428,26.17647058823529
35910831,541,447,29,429,1,6,1453,69.23606331727461,50.986842105263165
35910843,324,354,23,153,0,2,856,58.64485981308412,33.45864661654135
35910855,290,167,14,122,1,1,595,71.9327731092437,45.24590163934427
35910995,111,288,61,198,0,1,659,56.297420333839156,47.44525547445255
35911008,297,310,32,278,1,2,920,66.30434782608697,50.24077046548956
35911033,149,102,5,55,0,0,311,67.20257234726688,37.03703703703704
35911537,308,304,43,301,0,0,956,68.2008368200837,53.086419753086425
35912268,220,347,44,287,2,1,901,61.48723640399556,49.04552129221733
35913431,115,76,7,75,0,0,273,72.16117216117216,51.89873417721519
35913649,282,142,8,82,3,0,517,72.5338491295938,39.57446808510638
35913820,34,170,20,63,0,0,287,40.76655052264808,32.80632411067194
35914678,487,250,19,123,2,1,882,71.65532879818595,36.70886075949367
35914691,357,410,47,468,1,0,1283,68.04364770070148,55.72354211663067
35914708,404,381,23,335,7,8,1158,67.09844559585491,49.46949602122016
35914712,516,173,18,202,3,0,912,81.03070175438596,56.313131313131315
35914721,602,439,40,311,4,2,1398,68.59799713876967,44.84924623115578
35914733,274,392,70,442,0,2,1180,66.77966101694915,56.73289183222958
35914745,317,320,32,345,0,4,1018,68.56581532416503,54.35092724679029
35914812,363,197,11,83,0,2,656,69.96951219512195,32.76450511945392
35914824,572,323,28,251,2,0,1176,72.53401360544218,46.52317880794702
35914836,407,183,17,125,2,0,734,75.06811989100818,44.03669724770643
35915658,227,346,27,135,2,1,738,53.116531165311656,32.289628180039145
35915661,427,227,22,168,1,2,847,73.19952774498229,45.952380952380956
35915671,350,332,38,284,5,3,1012,67.19367588932806,49.84894259818731
35915683,384,302,23,285,1,3,998,69.73947895791584,50.814332247557005
35915695,256,112,16,113,0,0,497,77.46478873239437,53.52697095435685
35915701,756,321,32,349,2,1,1461,78.02874743326488,54.46808510638298
35915725,411,617,53,517,6,4,1608,61.629353233830855,48.45446950710108
35916493,177,244,40,232,4,1,698,65.0429799426934,53.16698656429942
35916500,353,248,20,120,1,0,742,66.57681940700809,36.24678663239075
35916511,199,150,17,159,1,0,526,71.48288973384031,54.12844036697248
35916523,468,303,47,357,3,4,1182,74.36548223350255,57.56302521008403
35916535,422,164,14,174,1,1,776,78.8659793814433,53.672316384180796
35916729,267,471,67,344,2,1,1152,59.11458333333333,46.77966101694915
35916730,409,707,48,415,4,4,1587,55.45053560176434,39.9830220713073
35916742,378,582,69,434,7,3,1473,60.48879837067209,46.84931506849315
35916754,535,374,33,294,0,2,1238,69.78998384491115,46.799431009957324
35916766,210,133,22,109,0,0,474,71.94092827004219,49.621212121212125
35916785,422,154,21,125,1,0,723,78.69986168741356,48.837209302325576
35916791,297,546,62,504,2,6,1417,61.46788990825688,51.24999999999999
35916808,392,229,20,264,0,2,907,74.75192943770672,55.53398058252428
35916812,115,42,5,80,0,2,244,82.78688524590164,67.44186046511628
35917382,293,368,62,373,2,0,1098,66.48451730418942,54.28571428571429
35917394,132,324,43,377,6,1,883,63.306908267270664,56.857523302263644
35917503,295,261,16,276,0,0,848,69.22169811320755,52.80289330922242
35918748,322,188,18,146,1,0,675,72.14814814814815,46.74220963172805
35918994,163,102,9,53,1,0,328,68.90243902439023,38.18181818181819
35920265,243,159,29,113,0,0,544,70.77205882352942,47.176079734219265
35920277,514,644,115,479,0,3,1755,63.3048433048433,48.10636583400484
35920997,349,341,31,417,4,0,1142,70.1401050788091,56.99873896595208
35921312,306,442,51,378,1,0,1178,62.478777589134125,49.31192660550459
35921324,321,246,29,311,1,5,913,73.05585980284775,58.445945945945944
35921464,414,181,15,132,2,3,747,75.76974564926373,45.64564564564565
35922092,207,157,18,148,0,1,531,70.4331450094162,51.543209876543216
35922146,179,233,8,171,0,0,591,60.575296108291035,43.44660194174757
35922249,72,325,35,262,2,1,697,53.3715925394548,48
35922250,262,201,25,128,3,4,623,67.73675762439808,44.32132963988919
35922894,428,1030,40,347,9,2,1856,44.504310344827594,27.871148459383754
35922900,358,303,35,241,1,3,941,67.80021253985123,48.02744425385935
35922912,43,78,8,54,0,0,183,57.377049180327866,44.285714285714285
35923047,380,706,60,527,2,3,1678,57.92610250297974,45.60862865947611
35923059,76,444,102,513,5,3,1143,61.15485564304461,58.38800374882849
35923254,255,1000,103,487,7,4,1856,46.120689655172406,37.53903810118676
35923266,469,933,55,386,5,5,1853,49.649217485159205,32.58670520231214
35923278,164,560,69,409,4,2,1208,53.642384105960275,46.36015325670498
35923285,635,351,34,337,0,3,1360,74.19117647058823,51.58620689655172
35923461,200,323,49,280,0,2,854,62.177985948477755,50.61162079510704
35923473,483,675,54,484,7,4,1707,60.456942003514946,44.85294117647059
35923497,521,299,40,242,4,2,1108,73.014440433213,49.063032367972745
35923503,470,561,107,491,5,2,1636,65.70904645476773,51.886792452830186
35923515,293,356,62,473,2,2,1188,70.03367003367002,60.22346368715083
35923527,148,108,9,84,0,0,349,69.05444126074498,46.26865671641791
35923539,231,199,13,169,0,0,612,67.48366013071896,47.76902887139107
35923540,287,102,10,75,1,0,475,78.52631578947368,45.74468085106383
35923552,126,348,15,210,0,0,699,50.214592274678104,39.26701570680628
35923564,456,226,15,177,0,2,876,74.20091324200912,46.19047619047619
35923576,486,215,32,302,1,1,1037,79.26711668273867,60.98003629764066
35923588,326,513,60,460,1,0,1360,62.279411764705884,50.38684719535783
35923597,696,516,41,424,3,3,1683,69.34046345811052,47.72036474164134
35923606,379,244,23,201,0,0,847,71.19244391971664,47.86324786324786
35923618,402,301,45,226,0,0,974,69.0965092402464,47.37762237762237
35923624,312,475,24,227,1,2,1041,54.37079731027858,34.84224965706447
35923667,342,199,24,172,2,0,739,73.07171853856562,49.87405541561712
35923679,198,359,18,182,4,1,762,52.887139107611546,36.347517730496456
35923692,56,249,21,88,6,0,420,40.714285714285715,31.59340659340659
35923795,86,143,16,130,0,3,378,62.169312169312164,51.027397260273965
35923813,389,224,28,252,2,0,895,74.97206703910615,55.73122529644269
35923916,878,547,50,539,7,8,2029,73.04090685066535,52.476107732406604
35923990,447,302,11,237,0,1,998,69.73947895791584,45.19056261343013
35924003,242,431,48,389,5,1,1116,61.379928315412194,50.68649885583524
35924015,294,187,20,166,1,0,668,72.0059880239521,50
35924027,385,204,17,210,1,0,817,75.03059975520195,52.77777777777778
35924209,346,203,12,81,2,1,645,68.52713178294574,32.10702341137124
35924246,400,164,14,96,2,2,678,75.81120943952803,41.007194244604314
35924258,285,196,24,235,2,1,743,73.62045760430686,57.20524017467249
35924271,193,301,48,235,2,4,783,61.5581098339719,48.98305084745763
35924374,632,394,50,340,5,0,1421,72.27304714989444,50.06337135614702
35924386,248,202,14,132,1,0,597,66.1641541038526,42.120343839541555
35924398,195,282,23,225,1,1,727,61.21045392022009,46.99248120300752
35924404,217,132,11,242,1,0,603,78.1094527363184,65.80310880829016
35924490,207,207,19,120,0,2,555,62.70270270270271,40.51724137931034
35924520,112,164,15,167,0,0,458,64.19213973799127,52.601156069364166
35924647,274,558,40,317,3,0,1192,53.187919463087255,39.21568627450981
35924684,891,354,49,545,1,1,1841,80.77131993481802,62.73684210526316
35924696,51,204,54,238,0,0,547,62.70566727605118,58.87096774193547
35924702,122,192,17,130,2,0,463,58.53131749460043,43.69501466275659
35924714,268,69,14,113,0,1,465,85.16129032258064,64.9746192893401
35924726,238,196,20,129,1,1,585,66.4957264957265,43.51585014409222
35924738,252,276,37,253,0,3,821,66.38246041412911,51.493848857644984
35924748,252,227,15,139,3,0,636,64.30817610062893,40.885416666666664
35924751,602,548,75,429,3,1,1658,66.94813027744271,48.10606060606061
35924763,270,338,49,280,1,2,940,64.04255319148936,49.55223880597015
35924775,130,40,10,44,0,1,225,82.22222222222221,57.89473684210527
35924787,284,239,41,316,2,0,882,72.90249433106575,60.0334448160535
35924799,557,110,18,105,0,0,790,86.07594936708861,52.78969957081545
35924805,78,228,43,303,1,0,653,65.08422664624808,60.34782608695652
35924817,234,78,7,118,0,0,437,82.15102974828376,61.57635467980296
35924829,399,332,30,454,4,2,1221,72.80917280917281,59.61070559610706
35925135,8,1,0,2,0,277,288,99.65277777777779,99.64285714285714
35925159,922,180,29,198,1,4,1334,86.50674662668666,56.310679611650485
35925160,334,191,33,321,1,1,881,78.32009080590238,65.08226691042047
35925172,407,526,54,713,5,2,1707,69.18570591681312,59.53846153846154
35925184,433,564,44,402,3,5,1451,61.1302549965541,44.59724950884086
35925196,337,359,41,425,1,1,1164,69.15807560137456,56.590084643288996
35925202,254,171,10,92,1,0,528,67.61363636363636,37.59124087591241
35925226,466,146,19,148,0,0,779,81.25802310654686,53.35463258785942
35925238,114,157,13,152,1,0,437,64.07322654462241,51.39318885448916
35925251,413,109,21,95,0,0,638,82.9153605015674,51.55555555555556
35925299,312,196,29,233,2,0,772,74.61139896373057,57.391304347826086
35925305,500,214,20,306,4,1,1045,79.52153110047847,60.73394495412844
35925317,654,444,65,550,1,1,1715,74.11078717201165,58.152686145146085
35925329,373,162,21,233,0,1,790,79.49367088607595,61.15107913669065
35925330,349,367,63,419,6,3,1207,69.5940347970174,57.226107226107224
35925342,225,99,16,282,0,0,622,84.08360128617363,75.06297229219143
35925354,465,286,23,279,1,1,1055,72.8909952606635,51.52542372881356
35925366,258,139,21,122,0,1,541,74.30683918669132,50.883392226148416
35925378,363,278,27,333,0,1,1002,72.2554890219561,56.49452269170578
35925385,158,43,3,41,0,0,245,82.44897959183673,50.57471264367817
35925391,127,302,40,387,1,1,858,64.80186480186481,58.686730506155946
35925408,180,203,4,137,1,0,525,61.33333333333333,41.15942028985508
35925412,467,160,14,160,1,1,803,80.07471980074719,52.38095238095239
35925433,295,225,40,172,1,2,735,69.38775510204081,48.86363636363637
35925445,141,233,20,307,0,0,701,66.76176890156918,58.39285714285714
35925457,375,357,40,435,4,4,1215,70.61728395061728,57.49999999999999
35925469,739,440,38,407,1,0,1625,72.92307692307692,50.33860045146727
35925500,219,461,24,299,7,3,1013,54.49160908193485,41.939546599496225
35925524,359,302,40,311,3,1,1016,70.2755905511811,54.03348554033486
35925767,155,247,21,102,1,1,527,53.13092979127134,33.602150537634415
35925861,289,351,21,297,3,1,962,63.51351351351351,47.84546805349182
35925871,387,633,50,332,7,4,1413,55.20169851380042,38.30409356725146
35925949,506,311,52,654,4,2,1529,79.65990843688685,69.59921798631477
35925998,38,81,9,74,0,0,202,59.900990099009896,50.609756097560975
35926048,928,440,58,392,2,5,1825,75.89041095890411,50.94760312151616
35926103,87,207,33,140,0,0,467,55.6745182012848,45.526315789473685
35980018,3709,3017,416,1826,62,23,9053,66.67403070805258,43.54416167664671
35985004,8,28,0,12,0,0,48,41.666666666666664,30.000000000000004
35985016,49,142,3,39,1,1,235,39.57446808510638,23.655913978494624
35985028,85,149,18,61,2,0,315,52.6984126984127,35.21739130434782
35985041,19,331,31,100,1,0,482,31.327800829875518,28.509719222462206
35985053,354,462,26,188,4,4,1038,55.49132947976878,32.45614035087719
35985065,88,79,8,62,0,0,237,66.66666666666667,46.97986577181208
35985089,379,697,70,299,6,2,1453,52.030282174810736,35.102420856610806
35985107,31,116,5,56,2,0,210,44.76190476190476,35.19553072625698
35985120,71,198,6,79,12,0,366,45.90163934426229,32.88135593220339
35985132,111,278,25,93,10,0,517,46.22823984526112,31.527093596059107
35985156,115,248,27,224,2,0,616,59.74025974025974,50.49900199600798
35985168,67,131,15,125,0,1,339,61.35693215339233,51.83823529411764
35985685,95,325,18,121,1,3,563,42.273534635879216,30.555555555555557
35985788,126,441,21,115,9,0,712,38.06179775280899,24.74402730375427
35990012,464,784,147,490,50,6,1941,59.608449252962394,46.91943127962085
